simplexmlelement	xml addchild containing simplexmlelement false held within representing object children node properties failure added whether child method document data class element
$condition_type	type condition
$error_handler	following callback signature
$cascade_candidate_limit	limit candidate
$nsname	diff document namespace name custom
$output	success command argument pem debugged every filled specified variable output array hold line present
$identifier	identifier call gnupg_init() gnupg
$height	chopped neighborhood image number surface height scaled arc border ellipse size rows raise area pattern virtual terminal source window template units new device-space local pixel rectangle returned exported extracted e target region thumbnail page
$dither	color list image dithered approximation indicates zero result dithering hilbert better distributes method refer used corresponding speckled along difference true pixels constants algorithm neighboring curve value reduced original dither
$option	ldap_opt_matched_dn set ldap_opt_server_controls ldap_opt_error_number cubrid_include_oid supported tidy related curlopt_xxx attempts used search ldap_opt_sizelimit type query array max-timeouts php supported: one ftp functions configuration network ldap_opt_referrals currently ldap_opt_host_name ldap_opt_network_timeout valid bool constants statement of: 5 parameter ldap_opt_timelimit available cubrid_exec_query_all ftp_timeout_sec return option &nbsp seconds oid ldap_opt_protocol_version ldap_opt_error_string cubrid_async ldap_opt_restart integer execution string conversion ldap_opt_client_controls name since ndots changes removed ldap_opt_deref fetch connection memcached::opt_* max-inflight timeout following runtime are: options unset
$agent	udm_alloc_agent() received link agent call
$hint	available level stands hint fieldcache top currently one top_fc
$attrlat	latitude attribute name
$array2	compare elements keys extracted second values array first
$buf	fetched chunk specified need lob containing data send source written reply sent body buffer object eventbuffer host part variable buf response received remote target
$isname	field set last name versions (= fdf toolkit value note older determined 0) 1) pdf converted parameter string
$xml_file	xml dump database rrd filename file original
$replace_by	found smiley string replace
$restrict	use xslt certain functions allow parameter called
$item	write constant name quoted may holds iteration value element current item describes integer array operation string
$exit_struct	information used form returning component running array
$blob	binary publickey data blob raw
$path_to	url path_from renamed
$ascii	code ascii
$table-name	table name view
$sql_param	string identifying bound value statement variable
$new_min	inputs training outputs scaling minimum new data
$maxlifetime	updated last sessions seconds maxlifetime removed
eventhttpconnection	eventhttpconnection object
$appname	specifies sybase logging string identifying reasons appname application connection
$revision	retrieve repository number listing integer check revision
$country_code	country see code two-letter geoip_country_code_by_name()
$charlist	word additional considered list escaped characters
$new_output_max	upper followed strictly bound scaling desired output data
$bordercolor	containing object string color representing imagickpixel border
$errornum	codes one curlm error curl constants
$full_status	return buffer levels active output true
$zip	zip_open() resource opened zip previously valid file handle returned
$srcy	y-coordinate source point
$srcx	source point x-coordinate
$domlist	domains combination
$wantsink	set corresponding displayed sink interface instead true
$dest_width	width image destination
$serialized	xml serialized storage representation document arrayobject
$cache_limiter	changed name cache specified value current cache_limiter limiter new
$using_exceptions	default exception activate false throwing deactivate true
$sec_level	noauthnopriv|authnopriv|authpriv) security level
$dir	files temporary created filename extracted directory path
$msgtype	received message stored type parameter
$icon	note shown folded style icon
$client_identifier	string chosen bytes long 64 user
mongocursor	cursor
$extr_prefix_all	variable prefix names
$configuration_file	path configuration file
$cache	cache type user file
$watch_descriptor	instance watch remove
$imageformat	image format
$seed	seed optional value
$dirent	directory entry
$dbaddr	description database user port connect host dbaddr sql url-style password type options name
$i5_decimal_sep	( db2_i5_sep_period period
$field_index	field numerical offset
$rows	rows return maximum image number height scaled region pixels
reflectionfunctionabstract	reflectionfunction object
$object_name	object javascript name passed
$max_bytes	maxmimum read bytes number buffer copy
$ca_path	path ca set
array[mongocommandcursor]	array mongocommandcursor objects
$left	eigenvectors upper x-coordinate column parameter button number coordinates filled window location passed position operand corner array optional page left-hand left
$row_number	odbc_fetch_row() set seeked pointer number next specific desired try result specified new requests 1-indexed fetch row_number row
$method_name	method name
$report_uncaught_exceptions	whether javascript controls reported immediately exceptions uncaught
$old_mbox	information old name mailbox see imap_open()
sammessage	occurs false method error
$array_or_countable	countable array object
$text_domain	domain get without current setting changing new message null
$timelimit	search seconds number long sets spend
$gupnp_signal_service_proxy_unavailable	whenever available emitted service
$newvalue	new option value
$bid	object-id object existing char blob slob identifier id
$initialize	given configure default argument tries base operating dns initialize true sensibly systemâ€™s
$rights	give user rights
$ldap_modify_batch_remove_all	attribute named removed values attrib
$savepath	name created may plain existing file directory original
$neuron	neuron number
$userdata	userdata third optional supplied callback passed parameter
sqlitedatabase	object null sqlitedatabase success error
$queryfield	query field
$metrictype	metric type constants one
$namespaceuri	node elements retrieve look xslt attribute create within namespace uri element specific parameter match
$rownumber	retrieve optionally number choose row
$param	values: links filestring number char pointer current 0: param content = may bound variable php received name udm_param_num_rows column parameter 1: mode following found identifier page
$stylesheet	style simplexmlelement domdocument object imported sheet
$condition_option	option condition
$afmfile	path file afm
$step	given used sequence value increase step elements increment
$nbytes	read bytes number
$year	1970-2000 inclusive number 32767 9999 depends year calendar 1 2000-2069 positive selected two 2037 valid 0-69 digit -4713 may mapping 70-100 four 14 value 1970 range values
$tail	cursor tailable
$iter	tar/zip splfileinfo iterator associatively maps returns objects either file location
$type	uniquely since clob resourcetype text supported harupage::ts_barn_doors_vertical_in prefix identify shading query ptr row xml parameters harupage::ts_barn_doors_horizontal_in 0 harupage::ts_blinds_vertical blob constant include resources return string notation vt_xxx input_encoding cubrid_lob possible records whether phar::gz integer harupage::ts_wipe_left wont represents these: resource case-sensitive internal_encoding = drop list joined specific radius_access_request tokyotyrant::rdb_recdbl either radial sql_best_rowid stream_sock_dgram record specifies set retrieve extended result specified operation index eventhttprequest::cmd_* item solrclient::search_servlet_type input_post cubrid_assoc xmlupdate stream_sock_stream axial odbc_specialcolumns() input_get stream_sock_raw cause harupage::ts_glitter_right possibles ends get_resources() retrieved use harupage::ts_glitter_down statistics solrclient::threads_servlet_type byte optional refer tokyotyrant::rdbms_* search socket column items values: mib fetch cname srv harupage::ts_wipe_right action commit create soa harupage::ts_replace named fetched communication image tokyotyrant::rdb_recint one itemorder boolean phar::bz2 stream_sock_seqpacket table array txt cubrid_object rpn lob given eventhttprequest::*_header compression service test used: system returns harupage::ts_box_in treat passed harupage::ts_wipe_down tokyotyrant::rdbrec_int type 4 function naptr harupage::ts_box_out way php_binary_read input_cookie img_gd2_raw line must case cubrid_num output_encoding algorithm default selects database value img_gd2_compressed values columns following stream_sock_rdm are: mx input_server solrclient::ping_servlet_type associated defined attribute argument harupage::ts_dissolve aaaa service: solrclient::update_servlet_type constant: need dns_get_record() id defines bzip2 harupage::ts_blinds_horizontal harupage::ts_glitter_top_left_to_bottom_right hostname pl/sql 1 solrclient::terms_servlet_type pdo::param_* of: input_env ns parameter used cubrid_both may object update recv() type-1 harupage::ts_wipe_up zlib a6 variable tokyotyrant::rdbrec_dbl php data constants third radius_accounting_request datatype bind harupage::ts_barn_doors_vertical_out lines harupage::ts_barn_doors_horizontal_out oracle operate order
$wildcard	pattern name check wildcard table
$blocking	queue fit script process space messages enough large frees reads another message sent wait
$action_name	name chosen 32 bytes long user action string
$clientoptions	hostname secure number one boolean connect array port containing writer indicating keys wt path solr response e name whether value server mode following
$batch_size	buffer records number batch
$result_type	ignored msql_both set constant pdo::fetch_* fbsql_assoc result type fetched array msql_num controls fbsql_num take indexed msql_assoc parameter returned format fbsql_both represented optional default deprecated values: following
$new_data1	second data string
$new_data2	data string third
$message_type	go says error
$rprop_decrease_factor	decrease factor
$max_epochs	epochs training continue maximum number
$fieldboostvalue	index boost value time
$preg_split_delim_capture	set returned parenthesized pattern well delimiter flag expression captured
$priv_passphrase	phrase pass privacy
$error_types	function shown used like mask controls error_handler setting ini error_reporting errors triggering
$hebrew	used based string output parameter format set hebrew fl true
imagickkernel	generated imagickkernel
$stroke_width	width stroke
$userid	used name database sent character server connect host client null-terminated user using identify db2 pointer id sql_attr_info_userid string
$crop	geometry string crop
$number_of_folds	divided cross number tested sets data
$pharpath	use within phar internal location path mounted archive
$max_chars_per_line	returned optional number per maximum indicates characters line parameter
$except	priority exceptional except high arriving streams listed exceptions watched array data sockets out-of-band
$table_name	queried delete convert copy name want insert string update know containing schema rows select wildcard table thats data check types matched
$new_input_min	lower followed strictly bound scaling desired input data
$jargon	information different parameters language extra contains two lists words distinguish spelling jargon parameter
$with_comments	retain comments output
$which	elements argument retrieved calculated starting next four field zero values others integer array parameter optional passing indicating
$numeric_prefix	provided used index numeric base indices array parameter prepended elements
$add_query_to_cache_if_not_exists	function name storage implementing handler add_query_to_cache_if_not_exists user functionality
$buffer	buffer written bytes number
$preferredmessagesize	specifies returned maximum records target integer byte retrieval size
$oauth_auth_type_form	body http parameters request oauth post append
$factor	regex stray fragment factor ideal fragmenter size
$event_handler	resource name database whenever event callback link arguments specified events one called posted
$service_level	requested mysqlnd_ms_qos_consistency_session service mysqlnd_ms_qos_consistency_strong level: mysqlnd_ms_qos_consistency_eventual
$blob_handle	handle opened ibase_blob_create() blob ibase_blob_open() fbsql_create_blob() returned
$user_string	user-supplied string
$pass	encryption pkcs#12 password unlocking file
$trusted_user	string value switch user key pass id trusted
$variable-name	parameter-number string bind specifying specified variable php parameter name
$max_memory	use temporary mb default bytes maximum amount 2 file memory
$broker	resource broker
$minwordlength	ignored length minimum word words
$callback_function	callable functions name
$attr	node attribute
$controller	controller destination name
$handler	mysqlnd_qc_handler_default set parser built-in number used exist message description containing severity true storage send state handler arguments type details function xml_parse() accessing string shall object expects order: path line representing must closure name clients error following five called
$bind_index	binding location parameters
$driver_options	pairs set key= object attribute holds returns value one pdostatement values array method >
$section	body read section part number
$artifact	name artifact delete
$antialias_steps	control used antialiasing text allows number colours
$delimiter	escaped rows also optional separates character token used one specified field delimiter set values file sets array element parameter filename
$linefeed	specifies end-of-line term line-folding multiple longer certain breaking lines linefeed eol rfc length mb_encode_mimeheader() performs act marker line
$writeconcern(mongodb\driver\writeconcern)	mongodb\driver\writeconcern apply write optionally operation
$additional_headers(optional)	end header inserted string email
$measureerror	quantized measures value zero images difference original
$mustunderstand	attribute mustunderstand value element header soap
$filter(array|object)	filter search
$sourcedoc	source document
$cascade_max_out_epochs	epochs maximum
$servicename	short name service
$i5_naming	udb cli turns system value db2_i5_naming_on iseries mode naming db2
$num_data	training data number
$language	used underscore language encoding 639 messages two optional dash e-mail code iso letter country consists parameter 3166
$body	content string
$days	specifies certificate days length valid time generated
$soap_request	request soap
v8jsexception	null either v8jsexception
$files	files load name paths extract image collection files/directories directory prefix names file refreshed need path array optional
solrparams	false success solrparam object value solrparams instance
$radius	random neighborhood center operation implode gaussian pixel effect radius choose extent blur circle counting pixels circular
$contents	containing set hash string format buffer text create use note serialized entry output contents
$src_im	resource source image link
$position	cursors: last parameter seek first number numeric scroll current zero-based position operation next optional fetch previous
$carry	case initial return holds iteration value instead first previous
$dns_base	case resolved eventdnsbase hostname object dns asyncronously null resolution block dns_base
$arg_num	argument offset
$mimemail	resource valid mime
$limited	detailed limited set return information default segment cache list value apcu_sma_info() individual apc_sma_info() entries exclude false true
$sourcefp	valid handle file
$dbx_result_index	set returned always object numerically dimensional 2 indexed array property data
$limiter	limiter
$rev1	paths revision number first
$rev2	paths second number revision
$store_result	shouldnt false interesting thus large indicate minimizing resultsets memory usage fetched optional store_result particularly
quickhashstringinthash	new quickhashstringinthash
$separator	separated functions consist parameters handler parser namespace aware tag various passed specified separator string name
$cainfo	information use certificate process ca see verification specified certificates cainfo hold parameter trusted
gearmantask	task false gearmantask oject could object failure added
$keydata	imported data key
$size_correction	correction size
$writecb	invoke descriptor desired writing write callback ready null event
$radix	10 radix defaults
$bestfit	box attempt fit whether image destination source distorted bounding inside resize
$seconds	seconds time maximum number timeout fractional execution wait
$req	functions used resource like object request send connection eventhttprequest optional eio_get_last_error()
$res	received udm_find() res link result call identifier
$ord	encoding vector position ord font parameter glyph
$cacert	cacert generated signed certificate
$small	requirement used around algorithm less 2300k half maximum roughly decompression works memory uses alternative drops true speed
$session_mode	available pecl since 1 version 5 oci8 php parameter
$red	color border component red value
$ref	described ref specification object server array normally check imap_open()
$colorize	containing object string color imagickpixel colorize
$new_width	width image scale
sdo_das_xml	exception described success sdo_das_xml object throws otherwise
$raw_request	xml raw request string server
$wordwrap	function set word delimited fit parameter wrapping full emulates stopping last line true whitespace
$from_encoding	separated from-coding conversion code from_encoding encoding character tries detect comma names specified array string
$workload	serialized back echo processed arbitrary data
$timeout_write	write timeout
$pathto	files path given extract
$pipeline	execute operators pipeline aggregation framework array
$pathname	load accessible full name read large create object watch fifo write client file filesystem directory path data
object	protocol imap_fetchstructure() toaddress still return-path: row access instance personal nmsgs except valid adl rfc2822 returned corresponds pop3 haruannotation document name success mailbox: server specific properties: found page set reference ccaddress related see result n message description errors currently formatted current new nntp message_id body full followup_to mailbox host objects mime key along reply_toaddress come properties sender column messages according senderaddress return_pathaddress imap_header() bcc: otherwise harupage fetched cc number one references haruencoder array evidle size rows system call bccaddress attribute successful envelope encoder sender: newsgroups line in_reply_to representing imap from: to: 1024 return_path remail headers r iterated error following similar detailed false process certain uri single seen null haruimage information containing cc: field internal attachment evcheck subject used reply-to: object driver includes moment characters date class structure recent correspond bcc flags time reply_to fromaddress
$handle(resource)	e resource stream
$note_value	note value
$fieldlength	field length
$lib_dir	specifies modes algorithm parameter lib_dir system module located algorithms location contain directory optional mode
$slant	slant level
$param_name	parameter name
$driverdata	driver parameter optional
sqlite3result	false successful sqlite3result object results prepared failure statement query execution
$session_data	encoded session data
$angle	angle multiple text left-to-right polaroid effect write 0 degrees 90 apply along reading measured must
$signum	signal number
$bytes_transferred	bytes_transferred applicable populated
$library	load extension platform filename also depends parameter
$clear_cache	function name clear_cache storage implementing handler functionality user
$schema_type	type data know want schema
$max_neurons	status added stdout network neural printing maximum number neurons report
$from_neuron	postion starting number neuron
$string	decode convert string quoted-printable recoded reversed search evaluated write tested written examined 8bit escape input quoted
$from_root	node xml doc recursively allows namespaces child instead root check
pdostatement	object false database successfully server failure pdostatement statement pdo::prepare() prepares
$color_space	color image space
$pct	two pct according 0 range images 100 merged
$ndocs	provided documents stream number ndocs found filled
$shmid	created memory shared identifier block shmop_open()
$preview	preview type
$bmax	blue upper limit
$case	case_lower default case_upper either
$max_item_length	items length array maximum sets
$id	declared give replace session kill specified id string current field document schema uniquekey returned object yaz_connect() link user _id resource rights value cursor connection identifier
$hconn	connection handle
$part	function determines returns one portion constants haystack recursivetreeiterator::prefix_*
$it	iterate iteratoraggregate recursiveiterator
$iv	ofb cbc used modes stream mcrypt_enc_get_iv_size() initialization calling cfb obtain iv non-null vector algorithms mode must normally block size
$x509	parameters list key/certificate see valid values
$calendar	convert name calculation cal_julian cal_jewish use one cal_french cal_gregorian take calendar month
$cascade_activation_functions	cascade array activation candidate functions
$startpos	position remote uploading file start
$dictionary	path dictionary cracklib
$set_element	content insert delete want element
$modifiers	function modifiers get default numeric value copied zend_acc_public
$open_entity_names	referenced name space-separated open list open_entity_names entity parse entities second including names parameter
$cursor	specifies resource forward-only value cursor statement passing db2_forward_only
$connops	control function mqcno also see action options structure
$cost_ins	cost insertion defines
$create_sid()	executed required callback session new id
$rrd_file	name rrd file restored database
$database_name	queried name created deleted selected msql database thats string
$unescaped_string	escaped string
$eol_style	eventbuffer:eol_* constants one
$dir_handle	resource opened previously directory handle opendir()
$gupnp_signal_device_proxy_unavailable	whenever device emitted available
$piggyback	boolean
reference	false network success neural error resource
$oldnode	node attribute old
$attribute	containing string attribute one group-by pdo::attr_* constants name
$num_cursors	request number cursors server
$val	variant value round current parameter check defines
$feature	test feature
$data_type	information used data explicit restrict single using parameter type pdo::param_* constants
$extr_refs	extracts references variables
$base_dir	files full contains relative add directory path archive
$var	stream indicates scalar boolean evaluated ispell check defines checked source parameter indicating may variable integer byte data limits serialized type value converted store unset
$font	harufont larger corresponding name latin2 encoding numbers registered fonts built-in identifiers 1 instance 3 2 5 4 imageloadfont() font valid higher
$fam_monitor	fam_monitor_xxx functions resource returned one
$token_secret	oauth token secret
$auth_passphrase	phrase authentication pass
$reference	compare reference image object containing imagick
$zip_entry	opened zip_entry_open() previously zip_read() directory entry returned
solrdocumentfield	instance false success failure object field solrdocumentfield
reflectiontype	return parameter object specified reflectiontype null type otherwise
$num_neurons2	second neurons number layer
$priv_key_id	resource string openssl_get_privatekey() formatted pem key returned
$num_neurons1	layer neurons number first
$sandbox	set object handling instance runkit_sandbox output class
$batchsize	batch return number per results
$form	destroyed going added component form
$client_info	string chosen bytes long 64 user
$failure_callback	function run upon allows callback user error specify encountering
$descriptorspec	represents process child number value descriptor key pass indexed array php
$column_key	column return compared values
$server_hash	cursor hash server
$component	add component form
$regs	function elements third parenthesized matches pattern argument regs substrings stored found array called
$imageid	ps_open_image_file() ps_open_image() resource returned image identifier
$functions	function name one export pass parameter string
$request_token_url	url token api request
$top	upper button number coordinates page y-coordinate window location position corner top left-hand row
$inc_by	associated incremented get value key variable
$cmp_function	function sort compare used parameters comparison cmp_function two accept callback entries pairs filled
$pxdoc	paradox returned database resource px_new() identifier
$end_element_handler	function xml named end_element_handlerresource string reference $name parameter parser two accept calling handler parameters: first end_element_handler $parser must
$i5_query_optimize	goal returning db2_first_io possible fast optimized queries output page first
exception	available otherwise exception null previous
$gearman_return_t	gearman valid return value
$columns	image number scaled width contents region pixels columns row
mongodb\driver\cursorid	cursor mongodb\driver\cursorid
$value_cb	callback null result
$relation	dbplus_open() copied relation opened
$cursor_def	and/or optional make allows cursor hold parameter scroll
$text	help encoding text escape displayed specified message measure note width written utf-8 show new draw string tested encoded line cleared measured decrypted geometry button calculated
$req_identifier	identifier request result cubrid_prepare()
$to_encoding	converted type string str encoding
$how	stream_shut_wr ev::break_* stream_shut_rd disable one transmissions pcntl_sigprocmask() constants: behavior sets following receptions stream_shut_rdwr constants
$max_table_length	incoming arrays maximum length result sets
$method	set image imagick::interpolate_* one rpc years calendar digest backend use based 1582 avoid method easter 1752 cipher gregorian distortion eventsslcontext::*_method constants dates remote name calculated allows cal_easter_roman
$gupnp_type_float	variable float type
$embedtext	containing formatting e string sequences
$close_path	closes set true optional current path parameter
$encoding_list	separated encoding list encoding_list character comma array
$max_acquire	processes set simultaneously acquire number max_acquire semaphore
$manual	specifies reset manually whether object event must
$result_identifier	ldap_list() dbx_query() ldap_search() set ibase_execute() returned created ldap evaluated internal result ibase_query() resource
$timestamp	given beginning script wake timestamp microseconds local current unix sunset defaults time taken integer parameter optional day sunrise
mongocommandcursor	cursor mongocommandcursor object
$argument_count	function takes number arguments sql aggregate
$magic_file	magic name database something file usually /path/to/magic like
$config	named yaf defined section one ini file path array configuration config
$border	color border
$faultname	used encoding fault proper wsdl select
$img_effect_overlay	pixel foreground overlay colour effect grey remain black take background white pixels
$offset	pointed move cuts pointer row non-negative character iconv_substr() shall 0 th input cursor_orientation string grapheme read insert beginning bytes arbitrary mean specifies tar/zip set retrieve searching relative see result specified operation extract sqlsrv_scroll_absolute subject pdo::fetch_ori_abs filename replacing reading modify offset path byte optional comparison search starts allows range periodic assign fetched point image within number $haystack array seeked source positive start sqlsrv_scroll_relative pdostatement removed representing specify scrollable look zero value cursor str items accessed want stream moved watcher substring indicates performed file decrement counting seek check absolute amount archive field internal split increment units parameter begin evperiodic::__construct() may object meaning characters whence data modes starting $offset phar counted portion position normally original unset
$accuracy	accuracy
$fk_qualifier	qualifier key foreign
imagickpixel	given set success color image imagickpixel object instance coordinates background true
$x3	control third point x-coordinate current moves
$x2	control bezier point x-coordinate curve ordinate second 2 coordinate x
$x1	control ordinate bezier point x-coordinate curve 1 coordinate x first
$readpreference(mongodb\driver\readpreference)	operation optionally select mongodb\driver\readpreference server
$frame	ornamental image border e surround
tokyotyrant	reference tokyotyrantexception object throws current failure method
$cookie	yaz serverldap_control_paged_result_response() opaque server session cookie structure sent proxy
$exp	positive base raise power
$alias	used shorthand name stream rather phar:// phar remove archive access alias full referred wrapper urls path property refer string matched
$source_string	source string parsed
$driveroptions	driver-specific string mongodb specification connection included options
$url	provided given set option repository url open eg request value yar location server curlopt_url absolute
$uri	associated target pointing script mongodb://[username:password@]host1[:port1][,host2[:port2], request uri write mongodb:// connection uri: output encode path document transformation
$cascade_min_out_epochs	epochs minimum
$ury	y-coordinate upper right corner
$urx	upper right corner x-coordinate
$module	constant module one specified null given log would assumed latter destination mongolog instead parameter used string form though preferred constants like name default either
$msgdesc	descriptor message mqmd
$connection_rate	network many rate controls connections connection
$full_info	information full turns on/off result display
$key	encrypted apc_define_constants() stored data row cache add systems updated return string get every using exact resource name array calling specific item release mcrypt_enc_get_key_size() set exists numeric value specified id message legal content shared public hash deleted retrieved key path obtained queue length resulting introduced apcu_store() block dont primary private one header smaller associated decrement size use segment 2 memory store function corresponding option must whether maximum apc_store() yaf_response_abstract::default_body fetch delete constant increment lock performed file check increased information encrypt prepend note field holding instead parameter used keys update user entry variable inserted identity fieldname representation hmac
$connection_string	separated use whitespace parameters settings default contains one instance connect contain oracle connection_string parameter empty
tokyotyrantiterator	tokyotyrantexception object method failure throws tokyotyrantiterator
$low	low point
$oid	large work glo read lock oid object write instance database want put existence identifier data check
$replace	search replaces object value replace imagick values found replacement
$resource	function corresponding errors resource returned db2_connect() db2_pconnect() failing limit set connection valid call statement db2_prepare() handle constant passed
$log	text commit string log
$xsd_file	path file xsd schema
$deferred_prepare	resource prepare turns deferred statement specified db2_deferred_prepare_on passing
$bbcode_initial_tags	containing bbcode parameters keys required value parse tag names correctly array associative
$quota_limit	kb quota_root maximum size
$defaulthost	default host name
$headerfault	used response header handling error report soap
$principal	principal
$extendedclass	extended class name
$layers	layers array layer sizes
$local_username	username omitted local_username used value
$consumer_secret	provided secret consumer service provider
$layer	layer number
$auth_protocol	sha authentication protocol md5
$parameter_type	styles hint data drivers alternate provides type quoting
$errcode	code reference ldap occurred 0 set result error variable
$database_password	password string database
$request_parameters	array request parameters
$json	decoded json string
$field_number	field 0 starting number offset
$spelling	requested one languages english spelling parameter
$dec_by	associated get value key variable decremented
messageformatter	formatter object
$zurl	host[:port][/database] string form takes
$preg_offset_capture	appendant string also flag every passed offset returned match occurring
$jd	julian day integer
$cost_del	cost deletion defines
$neurons_between_reports	status report printing neurons number
float	rounded text distortion expressed using threshold range font inverse candidate decay miter -i texture 0 factor input indicating codepoint string activation bound 2 bit steepness step-size success -- bytes radians p filling -1 predicted x page mean opacity square weight throwing numeric epochs rate arc arg fail best glyph describing network + / current 3 correctly imagickpixelexception boost correct available stagnation spacing guess step base tangent multiplier sine remainder appears change temperature search created shift density length gamma otherwise point color character image float number thereof set rising associated total stroking size given log hyperbolic width cosine fraction mse lowest 0-1 completed failure fontsize normalized line true percentage logarithm floating-point none word double base-10 sarprop value mu limit error false defined metric neuron minimum -123456789 ink floating null fill containing output connection 1 field answer parameter gmagickdraw channel higher status calculation used object variable elapsed lower natural neural calculated q cascade hypotenuse points greatest time sigma drawing gmagickpixelexception
$scanner_mode	default ini_scanner_normal either ini_scanner_raw
$iptcdata	written data
$attribs	attribs elements third contains attributes array parameter associative
$painttype	1 2 must
$locale	lang use set string locale variables categories environment formatting values names null empty arguments
$kernelstring	describes e string parameters
$to_hash	input string
$pubkeyfile	needs key format opensshs file public
$namespace_uri	type namespace uri name
$order	asc/desc solrquery::order_* order constants utilizes
$saturation	1 saturation full normalized value
$indent	xml indentation number argument header formatted str characters line optional specify first
$conn	resource returned sqlsrv_connect() connects server connection client call closed
$window_handle	hwnd window id
$usec	microseconds
splfileinfo	path file object parent splfileinfo
$num_layers	layers layer number including output input total
$user	username name number authentication user new
$mask	containing string character watch list every characters allowable events disallowed
$group	authentication specified group name number
$client_flags	load enable mysql_client_compress combination data local 128 handling constants: mysql_client_ignore_space following mysql_client_ssl parameter client_flags mysql_client_interactive
$num_output	data training ouputs number per
$new_value	get value assigned key found variable new pointer match
$numerator	precentage completed numerator fraction expressed
$tablename	table stored header name database
$ignore	ignore escaping characters
$i5_fetch_only	used positioned cannot updates cursors db2_i5_fetch_on read-only deletes
$facetquery	facet query
$error_message	explaining used hold reference database could error_message syntax opened generated set passed error message contain parameter check descriptive
$nanoseconds	nanoseconds timeout
$interlace	non-zero planeinterlace image partitioninterlace turned else interlace nointerlace bit lineinterlace scheme: interlaced
$values	xml containing overridden keys plain variables update value ids maps values names key attribute integer array document data associative
$cfg	eventconfig object optional
$ms_timeout	length wait response milliseconds time
iterator	norewinditerator() based passed iterator one current inner filteriterator recursivecachingiterator active entry null limititerator::__construct() sub
$column-name	column name
$array_result	information false returned weight matches array_result ids keys values attributes hash document
$callbacks	parameters handlers may content callbacks yaml following emitting array nodes associative
$train_data	resource training data network neural
dateinterval	new dateinterval instance
$callback_url	oauth callback url
$signal	kill useful call may optional signal send system value process 2 posix systems using operating parameter specify
$database	argument file specified selected msql current valid type catalog user integer db2 represents cataloged name resides database default changed server alias connection client path
$docs	instances array containing collection solrinputdocument
$frompath	current path repository
$prompt	message prompt
$draw	obtained name color object font size
$streams_context	stream_context_create() resource context stream created
$statement	executed one oci8 oci_execute() oci containing prepare markers valid oci_parse() statement ref optionally handle template database prepared sql must execute identifier target created parameter mysqlnd server cursor identifer
$value1	end value push array onto first
string	code issued global results month executing informix recode limiter query -_ saved row stub zone prefixed base64 environment 0 patched encrypted nodes subscription homepage friendly indicating division string sqlcode=cccc] existing ip_address charset array list large item session error_code noted servers work pass implemented imagetype_tiff_mm index errors hostkey sub opaque application/x-shockwave-flash section demangled decoding current version shared ; byte-stream [sqlstate body completion full hash len reported compressed address apache path table delimited copyright receive allows ignoring amount resulting options secure application/octet-stream substracted apc use working & contains readable two next handler call dns sybase msg type image/tiff separated successful alphabetic eventsslcontext occurred visual controlling particular yyyy-mm-dd imagetype_gif must substring lowercase endpoint word f url-encoded challenge internal modified judy anywhere values sent following route sqlite wand process attribute cryptographically msql accept escaped reflectionmethod imagetype_tiff_ii spl_autoload() phrase returned information end imagetype_swf namespace uncompressed 1 pathname image/bmp absolute parameter profile description may hashed wrong socket postfixed date data /expr/flags image/psd short attempt effective documentation element recoded specifying correlation representation order tty executed 32-character produces wddx pointed isnt including imagetype_swc omitting phpe9568f34-d428-11d2-a769-00aa001acf42 digest epoch platform detected happened return greater imagetype_bmp auto safe reflected modification subtraction front buffering arrayobject matched represents name cubrid identified token debug found went identifier hh:ii:ss domain loadfromstring() eg positioned recursivedirectoryiterator namespaceuri meta curlopt_returntransfer http operation event special category space since content method contained internet sqlcode) newly occurs given font release base mime byte text/plain compression thrown pairs evprepare created could messages openssl length iso signature hexadecimal throws first encoding variables symbolic number one textual message loaded size differ exists service unknown system comma response image/gif imagetype_psd constants statement bits store fbsql option svmexception reversed needle artifact task part packet translation representing 13 target double enabled submitted headers determined str iso-8859-1 prepended country files bootstrap false wasnt julian tidy argument phar raw null imagetype_wbmp contents phpversion() conversion built unescaped evstat image/iff note instance issuing flags = soap trace buffer object non-alphanumeric graphicsmagick cipher letter organization nothing selector inserted class key-value filesystem url doc calculated request uri uppercased place blenc salt hmac rpmreader yar_client apciterator text random tagged checkbox ii_charsetxx xml cell quoted parameters title cache terminal failed slob combo 8 constant local dn handle ssl cannot imagetype_png new represented secondary processes resource fields bytes email rfc crc 2060 x functionality set human dump locale tree frame module gmagick see radius result imagemagick calendar gtid responses fails subsequent currently formatted filename unable closed syncevent thumbnail available notice recently string_literal parent job gregorian key column_number serialization configuration optional commands last generator varname region according etc connection context reply login expression otherwise comment detailed color guaranteed format others loader header localname guid diff described yaml solr bbb int json describes tokyotyrantexception empty blob engine corresponding c month/day/year decompressed syncsemaphore imap present note_name case extracted exception unlike image/jp2 value lowercased cursor match error property mnogosearch succes resolved backslashes ip gzeof() encountered imagetype_iff memcached gearmanclient::setcontext() malformed sprintf() ascii id binary containing perform hostname archive shorter rot13 html split timestamp octal document status used temporary latency maxdb keydata oid upon deflate running user characters changing php stack recent rrdtool transaction database safely markup customized without client command soapfault deflated gzip position 3986 latest protocol clob boolean image/png imagickpixel obtain assigned quotes stored unicode mysql speed continent imagetype previous e v8js unique integer also character except day source setting location input haystack transformation rfc2822 details real sha-256 explode() read auto_increment possible possibly reads canonicalized insert using password like decrypted motorola necessary intel success follows modulus user-defined server api either always translated output imagetype_jpeg page specifies old truncated successfully library magickwand export specified phpe9568f35-d428-11d2-a769-00aa001acf42 ob_start() 5 glyph provided describing quoted-printable per sqlstate classes slash active seconds host offset mssql key_file: extension package column rararchive range regular extensions runtime key/data image redistributable namechoice three pair doesnt theoretically lob right_operand errno unmodified sequence snmp secret long custom start ipv4 function decoded sqlite3 form soundex jewish differences authenticator failure properly link encoded line true entry embedded default signed converted key_file 8-bit called aa associated image/jpeg defined stripped image/vnd t61 zend watcher images single exist file curl trailing parsed functions codes pdo::lastinsertid() imagetype_jp2 storage invalid field valid lookup utf-8 utf-7 node requested topic update generated imagetype_jb2 sql variable digested structure imagetype_jpx remote eof serialized interval flag strings portion sqlcode time directory salt-encrypted imagetype_jpc original
$extr_skip	variable collision dont overwrite existing
$composite_object	composite imagick object holds image
$y1	control 1 bezier ordinate point curve y-coordinate coordinate first
$y2	control ordinate point bezier curve y-coordinate second 2 coordinate
$y3	y-coordinate control third point
$mask_image	instance valid haruimage
$rprop_increase_factor	increase factor
$mincount	count minimum
$compcode	completion code
$signature	binary returned means successful raw generated openssl_sign() call signature similar string
$timeout_read	read timeout
$event	boolean buffered valid resource event
$gmtoffset	hours specified
$autoload	function load __autoload() magic whether class default call allow method __autoload automatically
$handle	dba_popen() fclose() point successfully kadm5 file pointer yet popen() opened open system data valid call closed local dba_open() store handle returned name get successful handler using fsockopen() must resource socket database created evaluated fopen() typically
$oauth_auth_type_none	none
$query_string	query prepared string statement sql
$ctx	object eventsslcontext class
$luminosity	scale luminosity value 1 0 full black normalized hs white
$signature_alg	int signature algorithms one
$pmo	put message mqpmo options
$caches	specifies purge cache
$x_resolution	horizontal resolution
$bson	bson deserialized
$longitude	west negative value radians longitude defaults pass east anchor
$baseclass	extend class want dom
$personal	owner account name
$isolation	isolation set type
$param_arr	indexed callback array passed parameters
$sparse_method	constants list method sparse refer
$input	pull multi-dimensional string stream exchange column object current buffer length objects values yaml parse input new array document measured
$newscope	closure associated associate keep current static scope one class
$entry	specifies modifications make within callback valid file path array archive delete
$from	xml instance domdocument source object oci-collection current renamed file document
$functionname	function name string
$interval	modes evperiodic::__construct() hint see watcher 0 meaning periodic detected specified expected operation quickly normally change
$gupnp_type_long	variable type long
$methods	described eventhttprequest::cmd_* parameters may mask four associative bit array constants methods
$default	returned provide variable cookie varialbe found parameter
$table	queried name database object connection tokyotyranttable active table thats
$trans_args	ibase_write ibase_rec_no_version combination ibase_consistency ibase_rec_version ibase_read trans_args ibase_nowait ibase_concurrency ibase_wait ibase_committed
$ldap_modify_batch_replace	named attribute current replaced specified values attrib
$tv_usec	see tv_sec description
$introspection	introspection identifier
$rprop_delta_zero	initial step-size
$optlist	end r0 r1 parameters start contain optlist also radius radial shading circle type must
$encoding_mode	mode encoding
$flags	evloop_nonblock code eventlistener::opt_* entries ssh2_fingerprint_md5 results msgrcv existing quotes out-of-band filters use: svn_ignore_externals ssh2_fingerprint_raw low-level 1 field svn_no_ignore preg_pattern_order glob_nosort written flags: 0 preg_split_no_empty according dbx_cmp_native occurring xattr_dontfollow alter match supported return returned combination get matches preg_offset_capture ldap_escape_filter possible preferred descending words shared combinations affect bit ev::run_nowait arrayobject matched sorting recognises ipc_create) array list resolv pkcs7 try svn_discover_changed_paths profiling follow either evloop_once specific disregard output | added function status set svn_all methods exists parenthesized svn_stop_on_copy creation joined direction: see stream_oob xattr_create pass fail option operation $matches event provided following: adds appear pattern currently access collisions subpattern slash new zend_acc_fetch mode token_parse or| full run ability ssh2_fingerprint_sha1 fetch/handle ascending add key offset flag: preg_split() runkit_import_* optional properties wait comparison c eio_readdir_* operator): socket ored items shm_rdonly allows svn_show_updates amount present context signature zend_acc_ block first already regardless dont family scanning connection numerically sqlite one doesnt logically determine sequences operator reserved invalid/numeric open along unit ssh2_fingerprint_hex files) use described additional (|) & data create patch system extraction call combined way memory type schema files direction dns oob reversed extended filesystemiterator flag link ldap_escape_dn cases dbx_cmp_text specify handling determines default out-of-date value w determined values behavior glob() following dbx_cmp_asc treated wait) loop operate control dbx_cmp_desc compare constant symbolic xdiff_patch_normal process attribute sense appendant bitwise pieces escaped libxml xdiff_patch_reverse type: need handle xattr parsed string information conversion verified glob_mark make svn:ignore bitmask invalid orders note also valid take normal svn_non_recursive modification document parameter events shmat) used may description in: binary keys dbx_cmp_number preg_set_order: contexts fetched segment class constants svn_omit_messages ldap_search() eio_o_* write database read non-empty mask together order passed flags sets directory every validation ev::run_once strings
$service_level_option	parameterize level option service requested
$disable	load enable false dom xmlwriter xmlreader entities libxml disable extensions external true
$capath	pem ca contains ssl pathname directory certificates trusted format
$hobj	object handle
$zoom	magnification factor
domprocessinginstruction	new error false occurred domprocessinginstruction
$ldap_modify_batch_remove	named attribute value values specified attrib removed
$other	evembed::__construct() used surface existing new select backend
$level	specifies protocol one concern compression mongolog option mongodb\driver\readconcern::local new nodes parameter return description read using copy data constants recent resides level value queries
$autocommit	autocommit handle turns value connection db2_autocommit_on specified resource passing
$index	$values set file iterator color attribute within number accessed relative appropriate 1-based result want path table array font archive index containing scale checked command-line start current field run location nullability new type node map corresponding string get retrieved precision collection scene offset integer bit inserted name search whose column clear names phar value element length values directory position pointers unset delete
$sigma	deviation gaussian effect standard sigma pixels
$args	item lock creation argument pass array size information service area much start program arguments passed order sent function f_setllw extended args like offset keys: optional class must begins locked parameters package default call_user_func_array() cmd request object options specific callback length plus constructor following works strings associative f_setlk
$success	optionally set success failure referenced value variable boolean pass fail false true
$directory	map delete target created root partition filesystem directory path disk open change name
$certificate	x following: certificate one
$matrix	color containing affine values matrix
$col_name	column know want schema
$ctor_args	array elements passed constructor
$charactername	full character name unicode
$resumepos	position downloading remote file start
$capped	fixed collection size
$cache_cb	caching callback null read-through
$reason	code ofthe qualifying explanation compcode brief send reason error message response
$return_float	set returned float instead array true
$bulk(mongodb\driver\bulkwrite)	mongodb\driver\bulkwrite execute
$proxy	connection identifier proxy service yaz
$arg4	img_filter_colorize value 0 127 alpha channel
$arg1	img_filter_brightness level brightness
$arg3	blue img_filter_colorize component value
$arg2	component img_filter_colorize green value
$ang1	beginning angle
$character_mask	character_mask want means also characters strip parameter specify
$right	eigenvectors right optional passed operand array parameter filled
$min_priority	priority max_interval max_callbacks enforced
$escape_char	optional sets character one escape escape_char parameter
$array1_sort_order	sort used argument array order previous
reflectionmethod	reflectionmethod instance prototype method
$tpl_content	string template
solrqueryresponse	exception success object failure solrqueryresponse throws
$facetsort	count index use sorting solrquery::facet_sort_count solrquery::facet_sort_index order
$i5_time_sep	separator used db2_i5_sep_colon time colon:
$large_object	lob resource returned pg_lo_open() object large postgresql
eventbase	eventhttp eventdnsbase optionally associated socket success eventbase buffer object eventlistener listener connection eventhttpconnection resource representing event
$error_function	function constant error
$initial	available case used process optional initial result array beginning final empty
$checkpoint	lengthy pause increments service stop value checkpoint start continue report progress operation periodically
$preserve	preserve keys default false members
$real	real array values
$registernodens	registernodens node optional specified disable context registration automatic
$fieldvalue	field value
$fieldname	field name string fdf
$remote_socket	connect socket address
$server_socket	connection socket accept server
$gid	group id
$token	used delimiter value splitting token str oauth
$newthis	function closure given unbound bind object bound call anonymous duration null
$tag	characters locale attribute tag de_de array array: describing title keys version ex: available used string format may possible v1 en_us key us_us language 30 maximum value ch_de etc values following non-empty example associative
$xresolution	new image resolution x
$more_entropy	result uniqid() unique set end additional generator likelihood increases value return add entropy combined using congruential true linear
$output_vector	scaled output vector
$softcommit	performant index on-disk refresh without manner guarantees view
$search_value	keys containing values returned specified
$newparent	new parent/superior entry
$old_file	path file first
$sec_name	usually username security name kind
$i5_commit	attribute i5_commit set db2_connect()
$bbcode_container	bbcode_create() bbcode_container resource returned
$str	smaller logical substring file phrase query extract parsed binary cut unescaped original written source detected split input decoded string hashed tokens compared encoded data secondary escaped url lowercased lucene converted strings
mongodb\driver\writeresult	mongodb\driver\writeresult success
$what	bitwise one see ini summed event description together setting assert_active option values parameter string may assert optional constants search default customized value flags following output passing options
$record	containing associated field values indexed e array data
$caching_it_flags	used internally flags behavior recursivecachingiterator affect
$cwd	initial command dir working
evtimer	object watcher success evtimer
$img_effect_alphablend	use false normal equivalent blending passing pixel imagealphablending()
$namespace	attribute specified namespace element header belongs child soap
$y-step	distance direction vertical pattern pixel placements
$iterator_class	use iterating iterator object classname array
$bind_value_type	bind type value
$data-type	constant as: type db2_char bound db2_binary one db2_double specifying sql variable db2_long php data
$dest_height	image destination height
$remote_file	path remote file
$weights	training index different set string parameters mapping weighting classes weights names sets account integer array unbalanced optional associative help
$extended	data flag extended meta returning
$sortdirection	sort direction
$stroke_opacity	opacity stroke
$diff	xml information containing domdocument object produced diff document method
$step_callback	function name item user-defined callback every aggregate apply php
reflectionextension	information extension defined object user-defined classes reflectionextension null representing class
$index_start	start given counting index
$write(string $sessionid, string $data)	needs write callback session closed saved called
$zp	pointer gz-file
$column_name	search name column character) accepts argument patterns zero _ characters column_name single match (%
$array1	function comparison compare elements run merge arrays replaced initial callback master sorted values array check first
$gupnp_type_int	variable integer type
$frameid	frame id3v2
$main_str	compared main string
$applname	used string database character identify server application host client null-terminated connect using sql_attr_info_applname db2 pointer sent name
$cap	endpoint harupage::butt_end values: squared one following path line must
$event_name2	15 events allowed
$event_name1	event name
$value	less text disabled prefix stored value/expression query ratio generator chosen miter disables send 0 add valid bool match string returning fragment fragmenting px_field_time insert servlet wont gray name level bytes item filling timeout translated set contiguous depends used specified altered px_field_timestamp append even appear / new fragments size concatenate faceting terms seconds px_field_date processing given cookie key active optional enables keep facet length action expression options otherwise comment within number header constant array keepalive use width statement type store function assign option artifact selector tokens binary flag part child encoded line true must case escaped whether instruction enabled maximum value highlight spanscorer property treated false attribute escape tidy watcher parse raw single minimum ini phrase decrement check evloop::run() collapse information compared paradox ev::run() prepend 1 field setting pad ignore_user_abort document parameter added unless see though update collection generated regular validity variable inserted included database serialized bind required element sets entry
$noise_type	noise type
$ok_packet	type ok packet
$params	operations set stream class_name $arr specified executing added pass query array substitute information end parameters optional params therefore $1 parameter used format objects $2 constants must $value training svm last = list parameterized keyed filter etc values specifying constructor called associative
$geometry	geometry image string
$request	xml instance yaf_request_abstract request desired recode type soap
$gmax	upper limit green
$n_retries	connect attempts number maximum
$maxlen	pre-allocation hint read maximum length data
$trimmarker	added end string truncated
$dbx_result_unbuffered	rows initially create 0 flag property data
$timezone_identifier	timezone europe/lisbon identifier like utc
$patch	function binary string created patch xdiff_string_bdiff() unified file xdiff_string_rabdiff()
$nameoroptions	may array either string
$initial_value	set currently value item doesnt exist
array	represent code partial iterator currentdatabase skip results month four executing elements: per consists query row whose meta-data white 0 present th resources division labels string activation nesting oci_error() entries bounding existing categories arrayiterator entire lstat() level list solution php_output_handler_user prototypes item spaces phase filling new_wand relation dir upper abbreviated rrd built-in request zero of: blue index errors sub directive current version shared erase-flag aliases public filled full hash got formats component objects libxmlerror address represented path along change box reflectionclass modifier inotify handlers kadm5_max_life items k diff deserialized bitmask resulting weekday graph options named addresses class_name hash_type visible unix api names chunks total use stream certificate distinct beginning contains two next handler call archives 6 msg scope associated md5 type stat() skewness sessions successful flags fieldnames text: ssl_version_number kurtosis none url-encoded modified dev per-query geometry versionstring values indicating following making original root history links process attribute importprocess mailboxes tag numbers php_output_handler_end returned information respective end streams: namespace blob 1 url-rewriter sid parameter blocks description &nbsp gopher_xxx mapping collection callback date horizontal data response constants mimetype entry sets documentation h:i element alias green representation operations checkbox 0-indexed distortion files/directories including statistical digest 24 multi-dimensional attribute-type group x-coordinate mysqlnd_memcache del , coordinates listing pending split non return 512-byte matches timestamp primary 9 nlink sorted multidimensional day matched document name edit cubrid settings userid denomintor 2d token mode luminosity found associative status square chunk hard mysqlnd_ms numeric inverted kadm5_max_rlife static device_type year quantum operation keyed mongodb\driver\server array category network factors since rev projected content may 7 wich leayer occurs red retrieved statistics cookie blksize members eigenvalues byte remainder additional thrown definition pairs nsapi g locations could messages openssl length kadm5_mod_time iso signature follows: throws first curl_version_xxx fetched features encoding variables number one instances owner message full_status open imap_errors() size given reflectionfunction service width [last_author] detailing system consisting 2 types ordered structures uris schema hue 8601 option [time_t] facet kadm5_principal blacklist split_length dio_stat() copy representing percentage 11 10 version_number 12 keyword value/session tree second headers r matrix identifiers false plaintext argument dash raw paramaters null msg_perm built cascade delimiter object_id client extracted internal indexed algorithms = soap added trace buffer gmagick object graphicsmagick regular connected ** 0-based device alpha array[created_rev] quantumrangelong class kadm5_attributes non-blocking key-value fills url calculated ssl_version uppercased points databases reflectionparameter fieldproperties d) text supported fieldtypes padded session errstr corner php_output_handler_cont completion access highest based parameters title udn cache state 8 folder b columns dn count cannot php_output_handler_start words new keys: depending processes resource uids artist cached fields versions bytes method arrays versionnumber contain x fixed kernel declared set reference locale backtrace configured connections see num result calendar subject registering pattern currently formatted filename boundaries opened 3 quantumrangestring various groupid aggregation available imagemagick vertical module_name interfaces mailbox windows key interface setlocale() configuration kadm5_princ_expire_time pixels c last always similar flipped pdo etc protection wrappers attributes otherwise indice point color solrclient corresponds sampling active table allocated inode stroking described internally optional three msg_stat_queue wasnt tokyotyrantexception collected empty location username histogram optionally search month/day/year success: like: imap protocols zlib batch value n cursor key/values substrings error property pool sphinxclient::query() neurons io throwing id binary containing author lengths resourceid hostname connected-to kadm5_last_failed arguments modification filtered principals events week extended http keys numerical upon functions alert allocation running user characters php stack recent lower modes database rdev unpacked without command components filesystem items: position result_id dimension left protocol opcode imagickpixel targetreference assigned info-array stored returned: unicode using gmagickpixel generator kadm5_mod_name imagick character y-coordinate simple 4 usage input chromaticity gmp resolved saturation vendor sha-256 format read (0 possible sha-1 integer bit height kadm5_kvno like decrypted ctime success header table: sizes manual user-defined server inclued msgno output page pertaining right old kadm5_pw_expiration meta specified libz_version ob_start() matching describing dimensions id3 / getdocnamespaces core seconds hsl broken host width/height offset refers properties integers socket extension column numerator ids [n/d] acl range extensions host_path image numerically servers pair appropriate doesnt bson oauthprovider imagickexception methods lob rows log tagmarker errno array1 * snmp fields: start gid ipv4 fraction manager function sha-512 driver complete form inotify_instance registered memory ob_get_status() kadm5_fail_auth_count failure array-list repository: meanings: oauth line atime true type-hinted info applying fdf default attached record converted limit groupped > are: called detailed constant uid win32_ps_stat_proc() inclusive defined blocksize pid single ino exist ini file mtime php_output_handler_internal lifetime curl parsed file/directory genres fonts paradox storage fstat() enclosure field valid 5 details notifications revision requested elements mongodb update occurred iterators generated registry sql variable else structure upwards ago algorithm resolution age kadm5_last_success modules associatively cpu depth time kadm5_policy starting strings
$find_query_in_cache	function name storage implementing handler functionality user find_in_cache
$string_literal	string contains modified characters need special
$priv_protocol	aes des protocol privacy
$start_index	index array returned first
$dbase_identifier	returned database dbase_create() dbase_open() link identifier
$numcolors	colors number
$host	point ip address agent connections ftp dotted-quad hostname snmp cyrus field 2 master supports email notation may memcache replication host openldap listening sql using imap name memcached job server part either
$outer_bevel	bevel outer width
$estimated	estimated retrieve number entries
$value_compare_func	function comparison return greater second less considered respectively equal argument zero integer first must
$protocoloptions	message_length wire protocol message: identifier request 42 bytes value dbname mongodb used key request_id encoded message total namespace sent size
$dn	used name certificate entity ldap distinguished
$mtime	modification time
$db	database
$first_page	included range page labeling first
$deep	whether indicates nodes copy descendant
$connect_type	even identical created existing connection passed connection_string new pgsql_connect_force_new
$operation	following: lock acquire one reader shared operation lock_sh
$preg_set_order	set matches results 1 0 second array $matches orders first
$save_indexes	used numeric indexes try array save original
$new_size	new size
$c1, c2, c3, c4	see ps_setcolor() meaning
$increment	priority amount change value increment
$process	evaluated closed
$rowcount	db2_rowcount_prefetch_on count full db2_num_rows() means fetching selected request number used cursor prior returns client rollforward_only rows even row
$reverse	1 set reverse sorting
$retphar	full false returned phar path disk archive
$base_group_id	group password typically number file
$index_key	column index/keys use array returned
$mysqlnd_stmt	mysqlnd handle statement
$only_names	whether property return names
$gamma	amount gamma-correction value gamma
$key_compare_func	function comparison return greater second less considered respectively also equal argument keys zero callback done key_compare_func key indices integer first must
$max_matches	matches ram searching controls keep much searchd
$character	convert code character
$unserialize	set though serialized true mechanism session module using message treated
$cascade_candidate_stagnation_epochs	epochs cascade stagnation number candidate
$wouldblock	ewouldblock set would third true lock argument 1 condition errno optional block
$messageheaders	opcode request request_id bytes value server length response_id key reply id integer message identifier driver response
$flag	disables query saved show explicitly include resources \deleted array_filter_use_key using term expunge turns memcache_compressed item debug page silently replacement set result pass stats appear since implicit flushing cl_expunge freed terms component mailbox credits \seen compressed key generate pairs determining messages turn \answered otherwise within bound marked rfc2060 closing use array_filter_use_both removing \draft custom 2 store function enable \flagged flag true info whether zlib value sent highlight spanscorer enables false defined argument oci_lob_buffer_free want phrase feature note default bool arguments deletion instead document parameter may disable uses highlighting lower callback flags
$set_leading	function set text sets leading true
$sec	seconds epoch since number
evsignal	evsignal object success
$set	set false whether list signals flag array true unset wait
$y_resolution	resolution vertical
$result	among sqlite set fetched reference scan previously mysql_list_dbs() response: fbsql_db_query() servers cubrid_num executed result query cubrid_both array pointer pg_query() odbc_exec() size lob cubrid_query() cubrid_list_dbs() hold additional position evaluated term system textual call statement taken interbase cubrid_assoc type cubrid_prepare() pg_query_params() status information fbsql_list_fields() corresponding returned provided pg_lo_open() object ldap_search() number fbsql_query() step basically others variable postgresql pg_execute() given data response handle search resource stepsize serialized fbsql_list_tables() modified value large mysql_list_tables() request-specific cubrid_execute() representation entries identifier comes thats
$filesize	bytes number allocate
$events	ev_write and/or set combination ev_read buffer event::write ev::read evio::__construct() desired event::read flags ev::write event indicating |
$check_consistency	whether check consistency
$dest	containing determines new_file2 dest changed patch resulting merged file path document parameter viewed new_file1
$mime_encoded_text	encoded mime string
$version1	version number first
$cache_type	files information returned cache_type cached cache system user cleared otherwise
$version2	second version number
$targettopic	topic subscribe topic://topicname) identity
$i5_lib	used file default resolving character library indicates references value unqualified
$message_code	available code descriptive passed message event
closure	closure function false created object failure specified new newly
resource	executed stores show issued using results zip_entry_ stored relation mysql query font pointer row non-zero cubrid_query() style bbcode_container group parameters representing explain mssql_bind() seems fgetss() param writing failed internal ldap input columns identical handle returned combination returning read rpm_open() stop fwrite() methods fam referencing unique procedures execute gets resource success button bytes server large whether traversed -1 informix went identifier x509 raises subsystem magic set ssl-ftp pclose() accepted odbc successfully packet feof() plausible kadm5 result specified id matching index fails errors describing opened subsequent segment msql access everything ssh2 closed new newly reading method freed available xml dictionary tables modify v component mime compressed key output commands actual certificate created column mysqlnd equal queue connection ssh2_sftp_*() unidirectional context frontbase shared otherwise buffered statements point image except scaled right names table message open select succeeds lob use rows service publickey positive system wrapper next underlying indicate null handler statement semaphore type function request_identifier parser mssql_execute() successful memory search purposes failure finished train link decompressed child postgresql copy true must case multi calls fdf fbsql_tablename() neural value cursor descriptor match ms error fopen() similar mnogosearch procedural control hostname/port fclose() false stream process well describe one argument agent uri parse postscript list caused bzopen() file conn_identifier fetches return curl transparently parsed information containing mysql_unbuffered_query() monitoring form privileges event write sybase valid interbase msql_fetch_array() document requested used provided may it!) object resultset functions prepared running socket sql proc_close() data structure network ssh2_publickey_*() transaction attempt succeeded database later request persistent together sftp feof(), callback fgets() command sets directory entry first make
$xmlversion	xml version string
$http_headers	http etc accept user-agent headers client
$responsewriter	xml phps json following: one
$encoding	load specifies set words encoding defined text supported argument module one file encodings converting null aliases xml conversion documents type chosen character passed input/output mb_http_output() mbstring expected input document defining 4 used http string use functions yaml_utf16be_encoding part characters declaration checked php optional yaml_utf16le_encoding constants yaml_any_encoding name specifying default parameter required try client yaml_utf8_encoding sets output zlib_encoding_*
$link_identifier	dbx_connect() specified dbx isnt mysql opened assumed msql interbase ldap fbsql_pconnect() returned object ldap_connect() link sql fbsql_connect() transaction last mssql_connect() context mssql_pconnect() connection ms frontbase identifier
$isglobal	whether lock controls system-wide scope local
$dbx_result_assoc	respective used keys returned column field objects values effects accessed property data names
$to_neuron	postion neuron number terminating
$details	retrieve settings value current setting details
$setting	setting set like name foo=bar
$write_timeout	write seconds timeout
$isid	set false name true want type id otherwise
$preg_pattern_order	full parenthesized matches pattern results first strings 1 0 subpattern array $matches orders matched
$peername	available set name selected client connected address included transport
$fetch_flag	combination fetch_flag ored ibase_text ibase_unixtime together constants
$exception	exception description generator throw
$query_data	may array object containing properties
$state	eventbufferevent::ssl_accepting current ssl state eventbufferevent::ssl_open eventbufferevent::ssl_connecting connection:
$threshold	deskew inclusive attempting compress value 0 length minimum controls threshold 8 automatically 255
$exclusive	xpath exclusive enable provided namespace parsing prefixes nodes matched
$yray	direction ellipse ray
$delay	retries seconds items image ticks displayed second expressed number delay amount 1/100th time invalidating milliseconds wait
$pos	documents starting 0 position new document extract stream-1 first
$targets	files paths string parameter acceptable single warning target committed array local must
$local_socket	socket created url standard transport://target determined specified using formatting: type transport
$schema	tables oid like identifier dot-notation contains object 1 raw specified owner schema procedures must
$ex	ordinate x bounding rectangle ending
$ey	ordinate bounding rectangle ending
$optname	available debugging description information whether so_debug recorded reports socket_get_option() option function type options socket
$font_index	font resource returned imagepsloadfont()
$row	specifies index set scrollable current number page access cursor uses result offset link accessed fetch row
$rot	rotation angle degree
$oid_only	tables set name default oid field belongs oid_only instead true returned
$ids	declared uniquekey deleted ids field array document representing schema
$compose	composite operator
$lob1	lob identifier
$lob2	lob identifier
$observer	attach detach splobserver
$ed	rotation degrees ending
$exclude	documents set result excluded true matching
$priv_key	priv_key file pkcs#12 component corresponds private key cacert
$block	execute code block
$configargs	information signing used default finetune overriding system openssl process and/or export specifying file configargs configuration options fine-tune csr
$count	retries replacements passed read bytes number replace set done performed characters specified variable extract filled
$preg_split_no_empty	set returned pieces flag preg_split() non-empty
solrquery	used return object value current solrquery
$options(array)	operations executed ordered description default true parallel arbitrary server may bool mongodb unordered serially false order type options sent option
$field	content-type int number 1-based table index backup field tablename 0 document string may retrieved argument offset date integer representing name text/html column fields values: remove example url udm_field_content following udm_field_url identifier starting fetch dot otherwise
$subjectlength	greater number equal zero characters property fetchsubject must
$path_name	path name file
$new_link	established made opened mssql_pconnect() connection second already call cubrid_connect_with_url() instead link new identifier mysql_connect() returned arguments
$country	constant country identified id gender class
$activation_steepness	activation steepness
$idna_info	intl_idna_variant_uts46 used parameter variant
$session_id	read destroyed session data id
$class_method	method delimited class :: name
$retries	retry timeouts number times limit occur
domdocumentfragment	new false domdocumentfragment occurred error
$deleteoldrdn	rdn old value else non-distinguished values entry retained removed true
$imagecontents	content image
$trustedcontext	handle db2_trusted_context_enable turns value connection context passing trusted
$search_criteria	search criteria string imap2-format
$user_vars	user vars
$externalpath	url mount within phar external file directory path archive
$limit	set retrieve logs dump number rest substring specified return counts returned replacements group pattern amount 5 subject type used terms string matches cachedump possible entries last conjunction resource constraint maximum placed substrings limit requests
quickhashintstringhash	new quickhashintstringhash
$port	specifies mandatory point number af_inet connections peer numbers associated port use hold tcp/ip alternate system sockets better connecting master parameter higher af_inet6 udp used running may interfaces given argument replication host memcache listening address services designates data received lower made remote socket database memcached job server connection contact applies output requests listen connect
$shm_identifier	obtained resource shm_attach() handle returned memory shared identifier segment
$return_to_cache	function name return_to_cache storage implementing handler functionality user
$working_copy	files working uncommitted export copy true
$anything	variable serialized
$fam	resource returned service connection fam_open() fam representing
$gravity	property gravity
returntype	false network success neural initial error resource step-size
$siginfo	siginfo informations containing set signal array parameter
threaded	new threaded anonymous object
$type_name	type name
$term_type	target /etc/termcap correspond one systems file entries term_type
$work	executed worker threaded referenced object
$community	read community
$ber_identifier	parameter maintained ber_identifier state internal location memory identifier pointer
$connection	specifies pdo_mysql pecl/mysqlnd_ms associated one variable api connect mysql false functions php service became would writes selected invalid valid interbase closed set type ext/mysql cloudscape handle returned mysqlnd initially mysqli derby given > oci_pconnect() link oci_new_connect() apache using db2 active obtained level resource ibm succeeded database cubrid db2_connect() server connection client extensions postgresql db2_pconnect() time oracle identifier oci_connect()
$update_query_run_time_stats	function name storage implementing handler functionality user update_query_run_time_stats
generator	executing currently generator object
$pk_owner	owner primary key
$parameter	function shutdown parameters possible callback zero passed pass passing identifier parameter method additional
$gupnp_signal_action_invoked	whenever action emitted invoked
$month	december relative vendÃ©miaire) 12 end depends inclusive days january selected number month 1 range valid period year calendar previous 13 5-6
$variable	set associated name bind evaluated environment statement sql variable php parameter bv_name thats
$data	tagged iterator text underlying encoded xml whose table_name appended character encrypted input sent utf-8 gzcompress() string insert matched decrypted resource classified large stored mode arbitrary output bytea sign second added append imported network content buffer written replaced associate processing compressed generate training postgresql current range signature hexadecimal previously cb image names directly table array well-formed backend lob given rows contains custom passed encode pi store decoded pairs gzdeflate() chdb e line specify must wish require instruction attached value px_retrieve_record() headers converted values loop associated stream attribute updated watcher escaped file returned binary containing end iso-8859-1 write field setting packed indexed parameter soap used keys object compress deflate cipher user salt-encrypted variable encrypt php data entry key-value third neural serialized request callback representation
$parameter-number	specifies 1-indexed prepared statement position parameter
$date	date representing string
$doc	node simplexmlelement associated domxpath object transform instance transformed domdocument document solrinputdocument
$extr_overwrite	variable collision overwrite existing
$gupnp_type_string	variable type string
$chunk_size	desired chunk new size
$perm	bits permission permissions optional semaphore
$embed	set matrix embedded data value otherwise 0 glyph file included pdf font true document >
$dependencies	depends array registered names extension
$dirname	monitored name create phar new directory path archive empty
$faultactor	caused error string actor identifying
$stop_function	function constant stop
$word_space	spacing word page defines
$case_sensitive	default behaviour declared case-sensitive constants
$updateoptions	multi=true) object/modifications boolean allowed array matching description documents bool criteria new document type match option search update key multi=false), true matched multi created default value q u first updateoptions upsert
$debug_level	adding formed together xxx_trace integer constants
$new_height	image scale height
$maxwordlength	ignored length word maximum words
$lob_identifier_array	lob array identifier return cubrid_lob_get
$dash_on	dash style
$inputencoding	input stored data database encoding
$subject	notifying search otherwise string observer searched update strings splsubject examine haystack replaced input known mail array replace email sent subject
$raw_output	set true raw digest binary data returns setting raw_output instead return returned format encoded optional md5 16 binhex value length output otherwise
$ncolors	palette retained number maximum colors sets
$new_output_min	lower followed strictly bound scaling desired output data
$new_max	inputs training outputs maximum scaling new data
$atime	given set value filename access time atime present
$blobidarray	containing corresponding blobidarray text ids replace add blob query byte parameter columns ?
$blur	smaller larger 1 factor sharp blur blurry
$treedepth	integer zero normally value one
$quota_root	set form quota mailbox normally quota_root
$in_charset	input charset
$file_name	training hash name want saved filename file path save data
$clut	containing image object imagick lookup hald
$blue	blue border color component value
$new_location	url new endpoint
$wbmpname	path destination wbmp file
$i5_dbcs_alloc	db2_i5_dbcs_alloc_on scheme column turns dbcs value allocation growth 6x translation db2 size
$activation_function	activation constant functions
mixed	code iterator results existing ca_info query expressions row replacements meta-data 0 nodes division codepoint returned returning spool every attribute-type entire list correct item -1 refer second evaluated substchar index errors selected current waiting version simple_case_folding new method hash objects items example resulting weekday action options thats logical imagick boolean names chunks traversing select certificate remains positive contains negative next handler call associated type successful occurred flag normalized none printing values merged ms following didnt fetch stream process attribute tag allowed absolute information e_warning 1 instead beginnning parameter csr dequeued typed variant mapping date data types correspond element callback checkbox pointed jpeg negation isnt including pointer group chosen < pending happened return greater descendants matches array_rand() execute name domnodelist win32 merge mode timeout found count_chars() resultset disp_e_divbyzero associative signing retrieve numeric frequency quantum dirname extract message sunrise following: occurs retrieved byte remainder thrown language place w signature throws first encoding omitted variables number one array given reference win32_no_error priority 2 statement dbplus_err_unknown shifted passed needle rejected part gmagick simple_titlecase_mapping double tree depends xpath false wasnt argument null levelled contents option depending object_id also internal = channel unless buffer object callable printed entry class considered auto-commit bracket sunset onoff _id mongodb\bson\objectid show random label imploded xml dbx_query() parameters implementation explain cache basename columns nonce dependent ingres_execute() yielded closure resource cached fields default occurance implication set exists simplexmliterator relative pdoexception result com_exception subject instance fails invoked currently filename written correctly gregorian key picking simple_uppercase_mapping c last reverse array(0 equal pdo connection expression otherwise point color simply table json empty > field direction parser corresponding else decompressed case exception byte-value value replaced error property tampered id binary containing verified highlighted rules mb_http_output() document status independent used http keys initialization oid evio php lower database without flags ca_path position left less assigned stored returned: previous entire_row mysql_query() character param valid blob input haystack save opt format read possible possibly integer bit accepted string insert success either output accessible right successfully specified images matching apcuiterator power connection_id offset identifier would extension column block referenced statements previously image float two appropriate rows val snmp way forward function form version_compare() json_encode() failure encoded true arrays maximum simple_lowercase_mapping paired iterated problem called delete constant defined tokyotyrantexception flush single exist file parsed storage depth invalid sybase setting node requested elements generates describe update generated sql variable flushed value_name) e serialized required portion fieldname time original
$bcc	get receivers bcc headers excluded specified mail
$escape_string	escaped string
$len	fetched number want data lob use optional write read sent used return buffer len host characters buf comparison remote bytes maximum remove length strings reserve
$sigmode	signing mode
$waitsearcher	searcher opened registered visible query new main changes block making
$skip	pairs key-value cdb start many number ignore records skip databases using
evidle	object evidle success
$to	xml replaces domdocument addresses receivers receiver object file new mail document target sent name
$contextname	name context
$stack	whether images stack vertically
$result_id	ifx_prepare() ifx_query() returned only!) result_id queries odbc evaluated odbc_exec() valid interbase result type resource identifier resultid select
$bit_on	1/on); set false clear 0/off) bit true
$learning_momentum	momentum learning
$td	encryption mcrypt_module_open() returned descriptor
$bv_name	used bind statement variable colon-prefixed placeholder
$qualifier	os/390 qualifier servers running z/os databases db2
$recursive	declared allows creation nested boolean specified array dirname targets recursive returns nodes committing parent flag disable namespaces child true created directories required well pathname automatically
$conn_url	information string contains character server connection
imagickpixeliterator	imagickpixeliterator image section success
$force	even modifications set regardless script whether local invalidation invalidated deleted file necessary true
$cascade_num_candidate_groups	groups number candidate
$prefix	required useful reference within variables global restrict hosts prefix simultaneously happen label array xml extr_prefix_if_exists start namespace filename note instance scope several might used temporary string matches class object generated microsecond variable imported generate extr_prefix_same identifier name extr_prefix_invalid flags prepended extr_prefix_all page terms identifiers
$new_path	path target
tokyotyrantquery	success tokyotyrantquery tokyotyrantexception object throws current failure error method
$mis	fix work
$context	stream indicates result want diff array reference support generally note application valid 5 passed include status added returned associate object php data task resource stream_context_create() created many lines gupnp_context_new() callback context arbitrary identifier
mongoid	000000000000000000000000 new id value
$components	number components pixel
$min	lower random number value bound minimum gmp representing id
$algoname	publickey e algorithm
$reschedule_cb	callback reschedule
$minimal	set parameter long result want time take minimalize true size
$xpath	xpath filter array nodes
$hour	hour number month relative start determined year day
$bevent	buffered valid resource event
yaf_response_abstract	instance yaf_response_abstract
$still_running	operations reference whether running flag still tell
$stmt	specifies sqlsrv_prepare() set number statment executing executed mssql_init() result affected row lob containing rows next valid statement db2_prepare() resources metadata count handle returned sqlsrv_execute() stmt prepared data sqlsrv_query() obtained resource sqlsrv_prepare created fields cancelled freed called sqlsrv_query
$oldname	file/directory note old name
$system_id	notation declaration system entity system_id external fourth specified identifier parameter
$end_revision	log retrieve last number revision
$min_saving	specifies savings value actually amount minimum compressed store
mongodb\driver\cursor	mongodb\driver\cursor success
$ignore_upsert_status	status insert whether update / ignore
$filter	simple image see boolean filters allowed information use described rfc4515 ldap empty full format operators using netscape advanced sdk search documentation filter directory
$gmo	message mqgmo options get
$error_code	obtained code error sqlite_last_error() used passed fdf_errno() might icu
$stringparam	used
$maxsegments	segments optimizes number
$region_code	geoip_region_by_name() code region digit see two-letter
$numprimkeys	keys number primary
pool	new pool
$dash_off	dash style
$cmd	execute set lock cleared operations: executed command following one f_setlk
$rprop_delta_max	maximum step-size
$fq	filter query remove
$fp	descriptor file target stream
$fl	available cal_jewish_add_alafim_geresh cal_jewish_add_gereshayim cal_jewish_add_alafim formats are:
$blob_data	data blob
$foreground	obtained foreground set color text painted setting identifier parameter imagecolorallocate()
quickhashintset	new quickhashintset
directory	case false parameters instance wrong another error directory null
$fd	castable associated stream numeric file pass array functions opened integer two valid expected events resources returned listener fopen() resource php inserted reference must e socket normally signal evio::__construct() descriptor -1 either dio_open() similar
$fg	color foreground pair
$codepoint	integer codepoint e value
$owner	owner
$hostname	specifies www ssl:// ip number agent installed prefix connect domain port whose use dotted-quad tcp/ip record support hostname snmp also valid location dns internet include type form may ssl host qualified address tls remote name database parameter region tls:// openssl server looked-up connection client text either fully
$micro_seconds	microseconds halt time
$right_operand	operand right string
yaf_request_abstract	instance yaf_request_abstract
$use_keys	index use iterator whether element keys
$types	sequence list variables quotes single enclosed containing specify interest import parameter empty string may table_type () unquoted using types must request value passed values contain comma-separated
scalar	element current valid key null otherwise
$filtername	filter name
$object	look parser tidy datetime only: xml provided style compared associate contained check instance add test method map handle returned invoke whose object use date_create() tested non-static key data class change must identifier name calculated remove requests property fetch procedural
number	success hex_string sum float number value octal_string values representation integer new decimal absolute
$colnum	set resource column number stmt valid result
$length	random data write alternate writing bzread() return returned get read stop wave whichever longest string represents resource bytes contain found specifies used specified subject provided supplied everything written reading method ends extend retrieved use stmt desired exported offset byte optional comparison search socket range comes first omitted image number reached array size lob given line-end positive decode start copied type controlled removes line copy specify must begins 1024 maximum value ziparchive replaced str beginning argument substring indicates examine file trailing greater end depending length uncompressed 1 csv parameter elements truncate newline substract allowing characters included php segment eof required portion time
$addtl	given additional reference populated records passed
$index_end	index counting stop reaching
$new_input_max	upper followed strictly bound scaling desired input data
$content	information verified string stripped text signature surface filename content filled searched new data specify
$regex	pcre files used optional list filter regular expression
$iterations	1/100th image number delay second iterations loop
$db(string)	execute command name database
domattr	node false attribute occurred domattr replaced error new old
$tile_geometry	tiles e number per page row
$on_off	false turns equals debug output true
$green	color component border green value
$needle	applied note search string integer may needle character value one substring converted ordinal characters searched found haystack find look
$high	high point
$ndots	dots number
$storage	containing elements list storage remove current retain type pixel constants refer
$src_y	y-coordinate source point
$src_x	source point x-coordinate
$securityprefs	new security preferences
$levels	go directories number parent
recursiveregexiterator	current entry iterated iterator inner
$src_w	source width
$src_h	source height
$run	closure use ::run
$script	code script registered javascript invalidated path
$matches	provided multi-dimensional ordered matches search according results flags array filled
$webindex	web run within phar relative accessed path archive browser
$okay	okay receiving partial results
$fontfile	use name truetype wish collection url file path font
$rise	current text rising value defines
quickhashinthash	quickhashinthash new
$function_args	function separated comma arguments string
$bytes_max	populated applicable bytes_max
$read(string $sessionid)	return string read always callback session serialized encoded data empty must
$kerneltype	kernel type build e
$minute	relative start number minute hour
$datefield	date field name
$hebrew_text	input string hebrew
solrdismaxquery	solrdismaxquery
$name1	name check
$name0	name check
$errline	raised errline parameter contains number fourth error integer line optional
$admin_server	server
$operationheaders	none documents protocol start created exhausted many offset value server cursor 0 bitmask flags key cursor_id integer trip starting id returned
$slop	field amount slop
$substrchar	s: none code string È) jis+7e7e) character value one u+3000 long unicode output following integer entity example: specify
$arr	arr elements list alternately portion length black white
$oldset	containing set previously list signals oldset array parameter blocked
$version	xml files version may contain allows number feature 1 part mp3 declaration test tag document soap specify
$errmsg	set string reference ldap occurred result error variable message empty
$severity	stream_notify_severity_* severity notification one error new message constants
$arg	associated process argument escaped event angle calculate data custom arguments passed parameter callbacks user variable optional logarithm attached radians value callback command com
$ftp_stream	ftp connection identifier link
$session	obtained ssh2_connect() connection call ssh link identifier
$auto_release	specifies request released shutdown semaphore automatically
$sql	executed string prepared statement sql query defines
$is_prefix	false regarded uri prefix defaults is_prefix ns true
$var_array	array
$server_path	web server file hosted path folder
$start	specifies sequence skip searching indicates zero arc counting byte returned non-negative angle positive start degrees th exporting reading parameter begin used string extend replacing retrieved subject number rows offset bit data search rotation substracted required value ziparchive record position starting first
$frame_name	frame name string
$msg_number	message number
$notext	information false additional human-readable optional verbosity affects included output parameter notext
$orientation	orientation constants one
$displace	amount displace image colormap
$streamid	ssh2 stream channel
$convmap	specifies convert code area convmap array
thread	executing object representing currently thread
$patterns_and_callbacks	callbacks keys mapping patterns values array associative
$error_callback	set occurred yar callback call error
$line_pos	line seek number zero-based
$signature_method	use default optional oauth_sig_method_hmacsha1 signature hmac-sha1 parameter method defines
$public_id	xml none required public_id string normalized external declaration spec entity empty specified notation identifier parameter public fifth whitespace
$pid	process pid one specified id absolute whose following: group evchild::__construct() current 0 -1 < status stat used possible child wait equal value values identifier changes
$label	add label
$wait	available exclusive lock number cursor become data milliseconds wait
$document	save array object
$update	update criteria
$oauth_auth_type_authorization	http parameters header pass oauth authorization
$gupnp_signal_device_proxy_available	available whenever emitted become device new
$modulus	modulus string
$username	username sybase use remote name database authentication alphanumeric connection connecting user oracle
$namespace(string)	fully qualified namespace e
$condition	set names table array row whose field call values previous conditions updated handle returned condition_type keys cond::create() variable condition must parameter table_name meet
mongocollection	object collection mongoinsertbatch new representing mongodeletebatch
variant	variant vt_date
$out_charset	output charset
$query	executed statements reference show defined escaped see set identify query rpn documents end semicolon parameters optional textual valid interbase statement criteria test handle string object search prepared properly ingres sql aql data solrparams execute ibase_prepare() inside documentation z39 parameterized lucene command type-1 representation guide
solrcollapsefunction	solrcollapsefunction
$document_or_id	given used reference object field array _id id
$fontname	font name
$contextnode	xpath contextnode specified relative queries optional
$shared_library	load name library
$register_shutdown	function register_shutdown_function() register session_write_close()
$aliases	set returned within included array true digest aliases
$softlimit	resource requires posix_rlimit_infinity whatever limit soft unit
$class	load function containing contains constant name extend restore receive workers object method classname instance test checked interface new copy class string
$intstep	fed interval database seconds rrd base data
$fromlength	fetchfrom property number characters
$passwd	password user
$base	associated decimal declaration number entity prefix systemid event string conversion identifiersystem_id format hex system note 0 taken new ; used returned notation associate buffer use includes var base external 8 natural optional logarithmic logarithm 10 e 16 starts 0x resolving determined defaults identifier octal otherwise
$variant	#46 uts object variant intl_idna_variant_2003 2003 intl_idna_variant_uts46 either idna
$connection_id	returned odbc see connection ibase_connect() link odbc_connect() interbase identifier details
$number	specifies convert protocol process retrieved decimal number value argument records numeric
$with_attrib	used returned well request values attributes rdns
$dict_type	dictionaries type
$tag_name	new add tag tag_set bbcode_container
$option_value	option parameter service value level
$ip_address	format ip host standard address
$upperbound	term stop
$uid	uid message identifier user id
$params_array	limited cli parameters setting optional sapi
eventbufferevent	new eventbufferevent object ssl
$old	stored currently old value
$uir	base uri
$detail	cause details error
$a	square rooted scan number distributiona perfect checked matrix divided width 5 location gmp parameter > added factorial modify multiplier php calculate 0) resource subtracted value either eigenvalues invert gamma
$inner_bevel	bevel inner width
$precision	specifies digits number database decimal precision bound variable optional round
$str2	distance string levenshtein one second evaluated strings
$timeout_type	imap_readtimeout following: imap_opentimeout one imap_closetimeout imap_writetimeout
$str1	distance string levenshtein one evaluated strings first
$fdf_document	fdf_open() returned fdf_create() fdf handle document fdf_open_string()
traversable	iterator implementing object instance traversable inner passed iteratoriterator::__construct()
$request_identifier	identifier
$autoindexid	index false created automatic field disable capped _id true specify
$yresolution	new image resolution
tokyotyranttable	tokyotyrantquery tokyotyrantexception object error new throws
$additional_parameters(optional)	sending sendmail_path used additional additional_parameters defined configured setting mail program flags pass command line configuration parameter options
$prepare_stmt	query prepare
$gmpnumber	php resource string number converted 5 either gmp exported
$rectangle	area coordinates 4 clickable array annotation
$new_file	path second file
$old_data	binary data string first
$scaling	scaling text horizontal showing page
$extension_name	registered name extension
$bbcode_arg_parser	bbcode_create() bbcode_container resource returned
$tv_sec	specifies tv_usec form seconds number together timeout microseconds tv_sec parameter
$after	seconds trigger configures timer
$subscribed	subscribe set true service
sdo_das_xml_document	exception described success object sdo_das_xml_document throws
$effect	use false img_effect_alphablend normal equivalent img_effect_normal one img_effect_replace constants: blending following passing imagealphablending() true pixel replacement
$sessionhandler	sessionhandlerinterface implementing handler register sessionhandler instance session class
$max_callbacks	stop number events callbacks running -1 libevent limit check
$day	relative given days end 30 within depends number 1 range valid allowed 31 calendar month day previous
$authns	given resource name reference populated authoritative servers records passed
evprepare	evprepare return success object
$desiredmsgtype	returned desiredmsgtype queue 0 front message
phardata	exception success phardata object throws failure method
$layout	accepted: displayed one values following page harudoc::page_layout_single
datetimeimmutable	failure newly object false created
$sort_flags	sort_numeric compare sort() dont locale numerically second types based sort_flags flags: current details sort_string parameter sort_locale_string sort used see may modify using optional change sorting type values: sort_regular behavior items normally strings
$n	php resource divided number 5 either gmp
$extended_data	files information extended set extract long unix acls owner true archive present ntfs
$i	row/table integer number) index
$f	color foreground return reference pair
$g	return reference color component value 0 green 1000
$d	modulo divided number evaluated height multiplier n
$mutex	handle returned caller owned call mutex::create() locked previous
$b	reference color number blue matrix divided 0 5 gmp added return vertical component background pair php b resource subtracted radians value either skew 1000
$c	draw skew character horizontal radians
$desired_error	function fann_get_bit_fail() chosen fann_get_mse() depending stop desired fann_set_train_stop_function()
$sp_name	stored ownew name procedure like
$rpath	use return upon delivery failure mail path parameter specify
$x	origin chopped point text image displayed primary floodfill system middle width specified corner operation border ellipse blue given position composited x-coordinate character basepoint coordinates start factor chromaticity pixel rectangle define circles area direction lower-left scaling coordinate region exported offset dividend horizontal ending pixels center extracted lower origo target column x-point bottom roughly top-left length green translated x first starting side left
$y	origin chopped coordinate point text image displayed primary floodfill ending middle second specified corner operation border ellipse row blue baseline bottom character system y-coordinate start factor chromaticity pixel rectangle circles direction vertical lower-left center scaling translated exported offset y-point pixels target extracted lower origo divisor region area composited top-left height length green y-ordinate position first starting side left
$x0, x1, y0, y1	end point coordinates start shading y1 y0 x0 x1
$r	0) return reference color component value 0 shape gamma > parameter distributionr red 1000
$p	php resource number 5 either gmp
$q	q query search parameter string
$status	function prints code win32_service_running win32_service_stop_pending pcntl_wtermsig() one pcntl_waitpid() win32_service_paused server pcntl_wstopsig() information service flagged supplied win32_service_pause_pending successful call online parameter store status string buffer controls win32_service_start_pending pcntl_wifstopped() using pcntl_wifexited() pcntl_wifsignaled() evaluated exiting functions: win32_service_stopped win32_service_continue_pending following output pcntl_wexitstatus()
$write_options	write array mongowritebatch::__construct options see
recursivearrayiterator	current entry array object iterator
$csr	previously generated openssl_csr_new() csr
$gray	value 1 0 black white must
$preserve_keys	determinate set form keys exactly results object_id snmp::oid_output_format preserve_keys used preserved taken array property true otherwise
$blob_id	blob id
$opacity	opacity containing imagickpixel object float value 1 transparency: level
$server_key	retrieve identifying value server key store
$collection	execute mongocollection name reference point database batch collection without
$reflector	export reflection
domtext	node false contains occurred domtext content offset error new type
$cascade_min_cand_epochs	epochs minimum candidate
$newname	new name
$points	containing consecutively vertices coordinates x array polygons
double	object success seconds trigger time watcher current evperiodic base supposed fractional evtimer next event loop absolute
$i5_time_fmt	standardization format time international hh iso organization db2_i5_fmt_iso
$dsn	dsn open
$comobject	resolved set name rules typelibrary object according instance either com com_load_typelib() comobject
$connections	fannconnection array objects
$hardlimit	posix_rlimit_infinity resource hard whatever limit requires unit
$servername	file defined servername argument server valid ms sql x interfaces name
$maxlength	length data maximum sets
$buffers	database cache number server-side allocate buffers
$origin	move beginning cubrid_cursor_current values: cubrid_cursor_last cursor forward cubrid_cursor_first location want following cubrid_cursor_first: parameter first
$vendor	vendor id
$revents	received bit mask events watcher
$xdoc	sdo_das_xml_document object
$queue	queue handle message resource
$dbx_colnames_lowercase	case lowercase returned column changed names
$assoc	returned object converted array true associative
$pgid	process group id
$address	stream ip af_inet connections elements: connect specified return array port peers containing dotted-quad alternate two 2 ipv4 parameter listen af_inet6 used http string notation given address peer remote unless socket_getpeername() made e socket created type appropriate server either output
$cursor_orientation	scrollable caller determines returned object value cursor pdostatement representing row
$wsdl	use soapserver uri mode file pass wsdl
$extension	used name extension default optional converted file override parameter archive
$max_tries	giving make maximum number repeated passed max_tries requests
$stream	open resource target stream created pointer pfsockopen() example) valid file stream_socket_client() fopen() import php fsockopen() check opened
$listener	object eventlistener
$as_array	return string indicate instead array true
$who	1 rusage_children called getrusage
$client_area	application area window include client
$alpha	given angle start level value 1 0 amount degrees 127 transparency: apply contrast
$lob_type	clobs following: temporary blobs create used one oci_temp_clob oci_temp_blob
$interface_name	interface name
directoryiterator	current item directoryiterator
$pagesize	page number entries
$word	lookup add word check
$permission	combination read flags: values user harudoc::enable_read document
$property	name constants) parser one see lookup unicode property intlchar::property_* constants option
$properties	control operation describing parameters receive polaroid remove array optional properties associative
$timeout_interval	see timeout_interval
$lowmark	low watermark
$new_password	new password set
$extraattribs	used additional extraattribs configuration options specify csr
$depth	set 16 recursion image bits: maximum depth user specified 8 32
$scope	identifier set value orders minimum result scope duration integer unique representing valid row
$denominator	completed denominator precentage fraction expressed
$object_id	set one assigned max_oids precedes array null id greater try given perform create snmp object_id oids taken method function requested oid multiple returned object use free else objects updates wanted count tree value server large queries property root
$destroy	successful pthreads unlock mutex destroy true
$direction	one harupage::landscape values: fribidi_rtl harupage::portrait fribidi_ltr following fribidi_auto must
$sarprop_temperature	sarprop temperature
$socket_type	af_unix based tcp/ip standard file apd_af_inet sockets
$auto_enable	set extension contexts enabled v8js true automatically
$target_frame	use frame displayed document parameter specify
$overwrite	overwritten files set name process true currently existing overwriting destination enable relation whether fields using document parameter documents overwrite
$epochs_between_reports	epochs function user number calling
$procedure	name procedure
$sortfilter	sort attribute use key
$modify	date/time string
$cert	path file name certificate rsa
$gupnp_signal_notify_failed	whenever notification fails emitted client
$encoder	haruencoder optional instance
$interface	interface name
$cor	word correct
$npriorities	priority levels number event
$function_code	function new code
$max_interval	0 interval stop events callbacks running libevent check
$dispinterface	idispatch name want interface display descendant
$amplitude	amplitude wave
$draw_settings	object imagickdraw settings text contains drawing
$ca_info	info ca set
$functionid	function read id factor
$date(string)	parse e string
$httponly	accessible made http cookie protocol true
$newrdn	new rdn
$allow_string	set false string object allowed parameter class name
$judy_type	judy used type
$training_algorithm	training constant algorithm
$round	function towards 0 truncated rounding values: argument gmp_div_q() defined see gmp_round_zero result following round description
$x_shear	x degrees number shear axis
$parameters	parameters markers prepared contained statement input array parameter matching
$ttl	seconds cache variable live time ttl var store
$i5_date_sep	slash/ date used separator db2_i5_sep_slash
$actor	attribute actor element header value soap
$mod	modulo
$search	pcre string matches needle value single regular names key searched known apc array otherwise expression expressions either
evperiodic	evperiodic object success watcher
$whence	specifies set oci_seek_set pos one file specified oci_seek_end use adds seek_set oci_seek_cur current of: interpreted: move may object possible negative offset end beginning default values: bytes equal value large whence values sets position are:
$passphrase	privkeyfile optionally key provided encrypted protected passphrase must
$enabled	whether antialiasing enable
$plaintext	decrypted code encrypt plaintext text signed source encrypted gets parameter filled plain
$enc_type	default php_query_rfc1738
$topath	path repository new
$compatid	compatibility id
$paramters	arguments calling
$verbose	detailed information whether recognised output classes
$src_image	resource source image link
$persistent	use set created dbx_persistent persistent controls connection boolean parameter
$before_needle	function strstr() determines occurrence excluding needle grapheme_strstr() portion returns part stristr() haystack true first
$foundonly	count information function skip applicable send cursor limit
$...	sort compare followed vars locale variables number assigned zero neurons another pass array parsed layers given additional parameters merge arguments flags function optionally run string keys operators use variable optional reference closure pipeline success settings arrays list try callback length values contain order block
$newobj(array|object)	containing e operators update either document
$read_timeout	read seconds timeout
$dst_h	destination height
$spool	spool flag
$argument	containing name reflection object reflect export either class string
$dst_w	width destination
$salt	salt base optional string hashing
$dst_x	point destination x-coordinate
$dst_y	y-coordinate destination point
$algorithm	used name algorithm one mcrypt_ciphername check constants string
$num_input	inputs training data number per
$format	activated month consists 24 1 character epoch phar::tar 0 4 weeks return string format %e %d overall b swatch accepted day january l h sunfuncs_ret_string time() abbreviated uppercase configured see result outputted saturday returned 01 space sun dst since current leap full seconds desired sunfuncs_ret_double offset optional digits similar 31 days recognized w otherwise followed image float number one specified unix datetime::createfromformat() table date() locale-aware use described additional leading textual iso-8601 returns 2 zeros cairoformat function repeater explanation two-digit specify utc 12 hour 16 single value formatting values str following z minutes example constant defined year argument --- apc_iter_* interpreted timezone sprintf() check beat/internet codes pack() 00:00:00 note sunday phar::zip sat parameter week used description monday %a preceding 16:46 characters date constants documentation 1970 u differences: time representation starting
$y_shear	degrees number shear axis
solrupdateresponse	exception solrclientexception success object failure solrupdateresponse throws
$destroy($sessionid)	executed set true destroyed callback session session_regenerate_id() destroy parameter session_destroy()
cairoimagesurface	cairoimagesurface object
$bpc	often component number per quite 8 bits
$psdoc	resource returned postscript file identifier ps_new()
$sftp	resource ssh2_sftp() ssh2 opened sftp
$delimiters	word delimiters contains separator characters optional
$url_encode	whether url-encoded return values
$prepend	autoloader appending spl_autoload_register() autoload prepend queue instead true
$repos	string repository url directory path check
$raise	raise effect value creates zero lowered 3-d otherwise
$param_key	parameter key
$signature1	fuzzy signature hash string first
$signature2	fuzzy second hash string signature
$hex_string	convert hexadecimal string
tidynode	node null tidynode parent otherwise
$qualifiedname	name attribute element prefix tag qualified prefix:tagname
$pk_table	table primary key
$data(array)	bson within array properties document
$template_dir	use yaf_dispatcher default application template directory path absolute
$serialize	message serialize optional sent controls
gmagickdraw	gmagickdraw object success
$unique	used attribute task identify particular unique id
$supervar_name	name key
$expiry	item time set expiry
$whitepoint	image white point
$memsize	size memory
svmmodel	used previously unseen svmmodel data classify
splfixedarray	content instance containing splfixedarray array
$extrainfo	float linespacing extrainfo possible indexes meaning key array type drawing defines
$expire	item expires cookie expiration time
$bind_value	binding actual value
$dbx_colnames_uppercase	case returned column uppercase changed names
$highmark	high watermark
$maximumrecordsize	specifies returned maximum record single target integer byte retrieval size
$sortorderby	sort criteria
$newval	index option value specified new store
$enum_print	net-snmp library interpreted 1 0 boolean value
$gupnp_type_boolean	variable boolean type
$cascade_output_change_fraction	cascade fraction change output
$cascade_output_stagnation_epochs	epochs cascade stagnation number output
$gupnp_signal_subscription_lost	service lost whenever emitted due error condition subscription
solrobject	xml server representing response solrobject
$bmin	blue lower limit
$dbmode	database may storage mode words sql dbmode select
$expiration	0 expiration defaults time
$iscritical	whether indicates pagination critical
$i5_date_fmt	used standardization format international iso organization date db2_i5_fmt_iso yyyy-mm-dd
$ann	resource network neural
$magnitude	real return image / pair magnitude phase imaginary true otherwise
$destination	resource harudestination image destination moved instance valid file
$parser_mode	instances parses documents solrresponse::parse_solr_doc solrdocument
$nullable	option nullable
parentiterator	object
$gtrid	gtrid global identifier transaction
$transfer_encoding	specifies transfer_encoding scheme mime encoding
integer	tagged code false series period numeric one executing tag trader_compatibility_* value id stack identity attribute new function trader_err_* corresponding factor worker failure compatibility constants name gender identified object length unstable mode error identifier
$start_revision	log first retrieve number revision
$crypto_strong	function used determines algorithm cryptographically value boolean strong passed e hold
$parser	code reference parser number entity set element line xml index functions end unparsed character start handler pi parameter function processing option notation get object use external declaration byte data column inside instruction calling error first
$inputgamma	input gamma
$workingdir	resolved relative contains string working paths current one note binary cleanup directory path php local
$attrlong	attribute name longitude
$disp_time	duration seconds display page
$real_usage	set get system unused including memory allocated total true pages
$write	write see streams listed watched array sockets block
$props	used create id new array properties theoretically
$clear_realpath_cache	whether realpath clear cache
$time	particulat item items rrd value server relative touch amount parts time date delete data updating wait
$close_type	connection closed
$intparam	used
$generator	object generator cache accepts argument value callable returns key
$genre_id	integer 147 ranging 0
$background	used background color text image float try antialiasing fade
$expression	xpath execute expression printed
$base_dn	dn directory base
$variable_key	variable key
$additional_headers	headers set mail string additional
$case_insensitive	defined constant set true case-insensitive
$data_size	bytes data size
$open(string $savepath, string $sessionname)	session executed like callback classes constructor works open opened
$radius_handle	resource radius
$mode	blob-object ifx_lo_rdwr ifx_lo_buffer text supported existing ifx_lo_rdonly already returned: affect huffman row write widest field lo_seek_end character controls wb9 0 blob 1=monday posix_r_ok include ifx_lo_append px_keytolower return string combination means read harupage::fill caller possible sorting iconv_mime_decode() imagick::alphachannel_* integer eio_s_i* strings: day permissions reading internally level h occurs whether read/write mode harupage::invisible specifies week abbreviated set creation cfb see used pass calendar event returned ecb rw ifx_lo_wronly operation rounding currently segment thumbnail access keys byte-blobs rb open() new content encounters consisting either wb (0=sunday given behaviour following img_nearest_neighbour mime harupage::fill_clipping optional recursiveiteratoriterator matching c anything created argument falloc_fl_keep_size values: turn w posix permission assign mcrypt_mode_modename wb1h via eio_falloc_fl_keep_size strategy: upper number one header doesnt operator array spellchecker open read-only use lo_seek_set compression harupage::fill_then_stroke transfer create system next returns 2 call 0777 memory type img_bicubic recursively wb6f convert english-gregorian else flag converted write-only specify must count save determines harupage::stroke_clipping f default wish require ifx_lo_nobuffer second harupage::fill_stroke_clipping n work img_bilinear_fixed r values behavior fopen() etc) nofb cbc lo_seek_cur documentation constant file stream int specified posix_f_ok bitwise px_keytoupper case single count_recursive exist malformed varchar null id defines information containing notation holds mode: check 1 also octal filtered count() parameter node posix_x_ok truncate buffer unused harupage::stroke meaning harupage::clipping two highlighting data annotation constants ofb img_bicubic_fixed lower e modes database montage = mask correspond auto-commit flags posix_w_ok directory typically order framing
$inc	increment
$ini	file ini contents parsed
$int	decoration text
$extra_headers	headers extra
sdo_dataobject	sdo_dataobject success
$backlog	not-yet-accepted number connections see defines network controls grow state details systemâ€™s parameter pending listen function may processing stack wait incoming documentation maximum queue length allow time queued backlog
$varname1	variable takes parameters number
$domain	available specifies convert used protocol sub family format parameter used: search name stream_pf_inet stream_pf_inet6 ascii-compatible domain nis cookie idna stream_pf_unix socket
$attributes	attributes array required e
$bufferlength	expected buffer length result
$node	subset node use compared simplexmlelement xml rather optional dom element specific without declaration output entire document parameter
$ordering	delimited list comma names provider
$auth_type	auth_type following parameters default optional oauth_auth_type_authorization decreasing consumer per one 1 header flags preference pass oauth parameter order authorization defines
$family	family address
$param_number	parameter offset
$latitude	north negative value radians defaults pass latitude anchor south
$link	returned ldap_connect() connection link ldap identifier name
$split_length	length maximum chunk
$record_number	index returned database number 1 records spans integer record dbase_numrecords()
$line	line added history
$root_device	device gupnp_root_device_new() identifier root returned
long	variable handle condition
$delta_x	x-axis traverse much seam
$callable_name	callable name receives
$packet_id	wddx returned packet wddx_packet_start()
$document(array|object)	insert document
$cluster_threshold	describing valid considered number contained minimum hexedra percentage pixels
$replacement	parenthesized text digitth replace substring imagick specified array matching contents containing \0 pattern contains digit elements string form may object produce removed \ entire colors substrings replaced contain strings replacement
$items	pairs array key/value store server
$scale	digits comparison set database optional decimal number used bound scaling scale place result factor variable specifies parameter image
$f404	found run location file script
$style	numbering array style colors pixel
$unit	represented hrtime\unit constant unit time
$sharpen	false value increase decrease sharpen true contrast
$problem	provided different ways three problem data
$errno	raised set connection number produced likely errstr provided fails socket() listen() errno contains system indicate valid call arguments parameter occurred integer optional holds present bind() actual socket calls level socket_last_error() system-level error connect() first
$extra_parameters	resource string parameters extra request send array additional
$searchresult	detailed search array result information
$available	available root_device set true
$compression_type	phar::bz2 compression defaults phar::gz one
$secure	secure indicates connection client transmitted https cookie
$trace	activate false process evchild::__construct() watcher terminates
$dbx_colnames_unchanged	case column changed returned names
$tiebreaker	specifies dismax use less float value 1 much something queries tiebreaker tie parameter
$headers	information openssl_pkcs7_encrypt() parameter) format signed parsed headers see prepended data array
$new_mbox	information name mailbox see new imap_open()
$destfp	handle destination written file encoded data
$reqengine	engine desired request
$weight	control 100-900 probability number servers relative array total information given font weight create selected connection valid buckets filled gathered pool value server turn range
$underlying	buffer ssl use socket event
$walk_to_top	available layers set whether apache variable top-level
$arg_separator	arg_separator
$double_encode	entities turned existing double_encode html encode php
$smooth_threshold	noise eliminates histogram
$x_rounding	rounding x
$point_size	size point
mongodb	new object db
$hue	hue described value 1 0 zero arc normalized fractional circle red
$fuzz	consider color image within colors defines two member much tolerance pixel match acceptable exactly particular must distance target default maximum amount fuzz similar
$frequency	minimum document frequency maximum
$criteria	cc one sortarrival spaces allowed keywords message subject following: sortcc sortsubject size sortsize arrival sortto sortfrom string criteria octets mailbox sortdate address date delimited following first
$encodedfile	save blenc source encoded filename
$category	named constant classification locale lc_collate strcoll() see responses category lc_numeric functions lc_monetary libintl character system setting: also lc_all localeconv() strtoupper() available affected string compiled conversion date php comparison lc_messages decimal lc_ctype strftime() formatting separator specifying time lc_time example
$errorcode	function fails code corresponding errno system value errorcode set specified variable return message optional
$autoload_function	function unregistered registered autoload
$with_cas	also whether request cas token values
$attrsonly	1 attribute set types wanted
$wrkstnname	workstation used string database character server connect host client null-terminated sent using identify db2 pointer sql_attr_info_wrkstnname name
$fill	containing object string color imagickpixel replacement representing fill
$offset(integer)	offset seek reading specified
$file	function radius_config() stream whoever image rrd argument existing writable file xdiff_string_rabdiff() font open binary configuration checked script personal currently passed save wordlist format dependent compiled tested path php png runs document resource name database created patch xdiff_string_bdiff() pathname architecture original e
$ctorparams	specified values class passed constructor
$priority	20 combination level -20 facility generally value watcher priority range associated event
$read_write	opened chain default filter attach read file reading stream_filter_append()
$field_override	override field overriding setting name
$errstr	fails set string see level connection contains system second errstr error errno message parameter description
$serial	issued serial optional number certificate
$protected_resource_url	url oauth protected resource
$new	use whether update value existing connection new one open
$format(string)	date used e format
$matte	false disables matte activates true channel
$image2	palette resource pointing image link image1 size
$outputgamma	output gamma
$image1	resource link image truecolor
$pkey	subsystem publickey resource
$enclosure	set optional character one field sets parameter enclosure
$new_setting	true false
$mindocfrequency	ignored docs many least frequency words sets occur
$boost	field boost value
$envs	envs environment program passed array strings
$onoff	status given enable false warnings whether optional changed enabled auto-commit disabled true auto commit parameter onoff
$munglist	containing php_self script_filename script_name indices array string request_uri
$classname	instantiate class string name
arrayiterator	arrayobject iterator
$shadingid	previously shading identifier ps_shading() created
$quality	smaller compression quality image ranges 0 worst file biggest integer 100 optional best
$pngname	path file png
$src	xml source document domdocument object
$source	xml gmagick containing used resource string composite image object parsed decompress parse source imagick relaxng php holds schema
$slabid	used dump cachedump slab set identify conjunction type
$namechoice	use set name get selector lookup names
$subscriptionid	returned existing subscribe call identifier method subscription
$retval	set option value
$conn_identifier	obtained previously cubrid connection call identifier cubrid_connect()
$column_number	index retrieve 0-indexed column wish number numeric zero-based row
$job_handle	status job task handle get
$to_parse	need parse string
$second	string seconds number relative start second minute
$include_dot	whether extension dot prepend
$file_handle	fopen() handle returned file
eventbuffer	associated buffer eventbuffer current instance output input event
$bg	color pair background
$command(mongodb\driver\command)	execute mongodb\driver\command
$bz	pointer file
$pair	foreground set retrieve get color number active colors background pair information define
$xml_string	xml string
$encoded_header	encoded string header
$io_interval	see io_interval
reflectionclass	reflectionclass object
$pipes	set end created pointers correspond file indexed array pipes phps
$errdat	resource network neural trainining either data
$queries	array objects tokyotyrantquery queries
$profile	profile
$definition	array defining arguments
$table-type	comma-delimited table identifiers list type
$process_identifier	prio_pgrp prio_process prio_user one
$new_file2	path file third
$new_file1	path second file
$event_base	needs resource re-initialized valid base event
$linebreak	linebreak yaml_crln_break chosen style yaml_ln_break yaml_any_break yaml_cr_break output
$i5_libl	used file character list resolving library indicates references value unqualified
evloop	object responsible watcher evloop event loop
$errfile	raised string third parameter contains errfile filename error optional
imagick	clip sequence image imagick images containing wand self contains current instance transformed new method returned object copy true success extracts mask region
$ang2	end angle
$ignore_max_retries	plugin whether ignore max_retries setting configuration
$trusted_password	string trusted_user corresponds user key specified password
$imap_stream	imap_open() imap stream returned
$newnode	node new
$clip_mask	imagick object mask containing clip
$cipher	use string algorithm encryption ciphers list one ssl allowable mcrypt_ciphername constants name
$use_include_path	include_path set constant want second file note use optional 1 trigger 5 include parameter used path php true search third file_use_include_path use_include_path
$name	protocol entity assigned collating stored iptc group calculate add local match return string possible exif:datetime) closure name list remove method session either node cookies set retrieve reference sequence relative see extended export event returned following: win32_create_service() icc content redefined example consisting aggregate processing cookie path placeholder socket extension created ps_get_parameter() soapheader urls action named remove: color variables one header references names table array short-name checked service contains tablename next handler semaphore type empty function option registered child removed af_unix arrays instruction second following property called delete constant file attribute tag want check absolute depending generic namespace id holding parameter profile used nodename object spot collection reflect user sql variable e reflection database clear element without searched oracle
$databases	containing udm_alloc_agent() string database url databases per one first contain array element parameter analog must
$targetpath	resolved relative contains string working paths current one note binary directory path php local check
$filtertype	following: image filtertype one colors img_filter_negate reverses
$strong	/dev/random used means setting entropy non-blocking true /dev/urandom otherwise
$privkey	obtained functions) set family previously openssl_pkey private generated key openssl_pkey_new() otherwise privkey
$tile	tile image used resource
$pfmfile	path optional pfa/pfb file
$inotify_instance	inotify_init() resource returned
$property_name	property name
$metric	metric list one type constants refer
$return	function capture print_r() set return like would parameter make use highlighted code export opposed emitting output true setting
$repeat	0 repeat
$tuple	back given attribute/value pairs data relation passed array parameter inserted associative
$autounlock	specifies script whether unlock semaphore php automatically conclusion
$close()	session executed like destructor write callback classes close works called
$imagetype	constant returned image one imagetype_xxx type thumbnail constants
$message	event end-of-line imap_mail_compose() two talking see stored terminator fail available operation message append descriptive \r\n use errors log errno logged except send cyrus passed mail receiving %m sent body unless string translated characters instead put imap present must received actual corresponding strerror value server queue replaced error \n onto
$log_file	path log file
$iptcblock	iptc binary block
$first_num	range number page first
$var_name	containing string variables strings etc either another variable naming array
$pointsize	text pointsize
$trans_time	duration seconds transition effect
$code	function code http send valid evaluated php response
$color	redefine retrieve wand color float number one gmagick matte gmagickpixel specified border check fill index containing get identification pixel indicating imagecolorallocate() imagickpixel string information object use compare background line representing constants created imagick stroke value filling channel identifier
$executable	executable determines whether parameter phar filename non-executable data treated archive
$internal_date	internaldate appended message set parameter
$msglist	described msglist range numbers rfc2060 message
$base_directory	files adding tar/zip full return splfileinfo remove iterators portion objects path archive
mongodb\driver\server	associated read cursor preference mongodb\driver\server matching
$proper_address	proper representation integer long address
$action	name service destination action identifier soap
$faultcode	code soapfault error
$db2_attr_case	specifies case result set natural returned column lower value db2_case_lower db2_case_natural passing names
$extracerts	specifies verify containing used name certificate extra cas extracerts untrusted specified help use filename file signature certificates include recipient example bunch
$machine	machine optional name
$invert	target color paints true pixel match
$attr_name	insert name read attribute work element instance know want delete schema
$envrion	loaded section config final
$return_var	status executed return unix argument placed written command variable output along return_var present
$resolver_function	callable arguments takes three
$rigidity	non-straight seams bias introduces
$perms	queue permissions
$summaryonly	information returned whether cache entries controls summary individual opcode user file contain array along
$role	5 interbase functional
$nth	positive root take
$mintermfrequency	ignored frequency terms docs source
$read	stream zero ready watched array precisely sockets string) fread() also listed reading available return see read characters particular end-of-file case resource socket socket_read() length streams become block
$known_string	known length string compare
domdocument	information domdocument resulting error diff false null merged
$dbname	name database
$keys	files integers pairs used retrieve string integer deleted request primary keys single values key contain key-value array strings
$space	space default allows value font change
$sizelimit	count fetched enables limit entries
$ctor	new array workers arguments passed
$log_function	function callback invoked events
$divisor	dividend number divides
$longopts	array options
$other_options	allows additional specify options
$img_effect_replace	use equivalent passing imagealphablending() true pixel replacement
$suffix	ends cut name component also suffix
$list	list type
$thickness	pixels thickness
$proc	proc
$proj	project identifier
$word_size	default 1 value
recursivecallbackfilteriterator	containing children recursivecallbackfilteriterator
$raw	case info stuff additional looping requestd raw going mode instead query type
$ch	curl_init() curl handle returned
$stmtname	execute name statement prepared
$cb	requested invoked received connections timer callable callback connection new path gets event
$ca	authority path file name certificate
$consumer_key	provided consumer service key provider
$cx	center x-coordinate
$cy	y-coordinate center
throwable	available throwable otherwise null previous
$x-step	distance direction pattern horizontal pixel placements
$local_file	overwritten already exists file path local
$xshear	image degrees number shear
evfork	evfork success object
$gc($lifetime)	invoked internally garbage data order purge callback session old php collector periodically
domnode	old number equal specified false null occur greater index namespace valid th nodes local node map nodename cloned found name type domnodelist uri error position
$varname	available name changed ini_set() variable using configuration options option
$maxsize	function set unless larger maximum queue maxsize flags specified fail described message accepted ; size
$channel	greenchannel constant auto-levelling color opacitychannel channels identify normalize extract: channel provide valid magentachannel contrast blackchannel return bluechannel cyanchannel redchannel yellowchannel applied mode done
$probabilities	probabilities value supplied filled
$new_data	binary second data string
$fieldcode	pgsql_diag_message_primary pgsql_diag_internal_position postgresql possible pgsql_diag_sqlstate pgsql_diag_message_detail values pgsql_diag_severity 8 pgsql_diag_message_hint fieldcode are: pgsql_diag_statement_position
$expungedeletes	merge segments away deletes
$matcheddn	dn set reference null within request one recognised variable otherwise matched
$silent	whether may errors mysqlnd emit
$crypted	encryption hold result
$note_name	note name
$notation_name	described name notation format per entity notations xml_set_notation_decl_handler() see
$retry_count	forever retry 0 default n retry_count -1 values times
$assoc_array	whose retrieved keys values meet deleted conditions field must converted table_name names fields table array row data inserted
$writeoptions	wtimeout executed force maximum ordered=true) primary writeconcern see boolean allowed ordered operation disk array verify write integer=server flushing wait milliseconds count returning journal replication key integer must case sequentually fsync string=replication-tag j batch value values w time options
$path1	path diff first
$path2	path second diff
$opened	false means initially open displayed closed true annotation
$yshear	image degrees number shear
$mailbox	information see name imap_open() mailbox
$haystack	occurrence entire search checked string get last needle input array first look
$tightness	control tightness space allows amount characters white
$real0	real array values
$real1	real array values
$constant	operator constant name value existing
$null_as	rows values sql represented null interpret
$md	descriptor message mqmd
$mh	curl_multi_init() curl handle multi returned
$extr_prefix_if_exists	exists prefixed non-prefixed create current version names variable table symbol
$ms	specifies operations processing allowed cumulative number server cursor limit time response milliseconds wait
$jpeg_file_name	path image jpeg
$starttime	database first rrd value time
$char_space	spacing character
$data_length	buffer length actual
$realm	connection authentication domain defines
$categorize	function multi-dimensional return keys second causing values constants array dimension categories first
$dst_image	resource image destination link
$gupnp_signal_service_proxy_available	available service whenever emitted become new
$case_insensitivity	case case_insensitivity insensitive true comparison
$fetchtype	predefined return specifying constant array type
$variable_name	variable retreive name
$row_b	second row
$row_a	row first
$in_fd	resource socket stream descriptor file input
$extr_if_exists	already exists symbol current nothing variable table overwrite otherwise
$deref	specifies search handled aliases
$extr_prefix_same	variable collision prefix name
$function	function name parameters list element reflect callback call every called constants refer
domelement	node added false domelement occurred errors error new occur
$julianday	julian day integer number
$errcontext	point errcontext parameter symbol occurred points error active table array optional fifth
$deleteoptions	default delete false option document deleteoptions first value 1 0 limit=1) documents limit key integer bool type matching limit=0), description
$start_element_handler	function xml named string reference $name parser three accept calling start_element_handlerresource first handler start_element_handler parameters: array $attribs parameter $parser must
$ns_prefixes	prefixes filter array namespace nodes
$width_height_type	width_height_type ssh2_term_unit_pixels ssh2_term_unit_chars one
$fingerprint	key fingerprint
$target	associated stream color image imagickpixel topic second remove specified message fill delivered containing publishing contains queuequeue://queuename topictopic://topicname paint identity pi parameter opacity object string may processing link change socket sending search resource target instruction value queue within
$sequence	numbers message description sequence
$vars	variable converted reference vars
$clob_handle	fbsql_create_clob() handle returned clob
$prevcount	count returns semaphore previous
$referrals	set returned reference referrals result variable array referral strings empty
$is_dst	represent set within influence daylight doesnt result parameters unknown dst 1 0 parameter gmt is_dst date default always whether savings -1 time
$mysqlnd_uh_res_mysqlnd_name	connection mysqlnd handle
$hash	password_hash() hash id created
$number_frames	in-between images number generate
$additional_parameter	parameter line mta command additional_parameter
$dev	specifies major special created dev eio_s_ifchr eio_s_ifblk numbers file device newly type minor
$var1	variable
$y_rounding	rounding
$ldap_modify_batch_add	named added additional attribute value values specified attrib
callable	function set false success object eventhttprequest yet callback evfork evcheck evidle
$dst_im	resource image destination link
$fk_owner	owner key foreign
$tcp_server	domain like ip tcp server unix file socket
$process_sections	get parameter process_sections settings setting names section included multidimensional true array
$warning	message warning throw
$comment	comment string packet header add optional appears
$accessible	false true accessibility allow
$binmode	specifies binary returned db2_binary passing data
$timeallowed	search allowed finish time
$collector	callable collector
$command	execute executed send escaped command com
$error	provided code http inside rejected stored parts error variable
$cast_as	stream_cast_as_stream calling stream_select() uses stream_cast_for_select called stream_cast()
$sarprop_weight_decay_shift	shift sarprop weight decay
$bit_fail_limit	fail bit limit
$locking	locking set type
$field_name	field name
$get_hash	function name storage get_hash implementing handler functionality user
reflectionproperty	reflectionproperty
$lob_identifier	lob set get result cubrid_lob2_new() identifier
$field_offset	0 wasnt starts retrieved numerical specified next field isnt offset yet sybase_fetch_field()
$dividend	divided number
$options	currently name/value together: quickhashinthash::do_not_use_zend_alloc global resolution se_noprefetch ft_internal manager versionsoap_version, quickhashstringinthash::check_for_dupes 134 pgsql_dml_no_conv causes newlines pathinfo_extension libxml_* parameters encoding character except pgsql_dml_string 0 internal collections present 2400 $arr enumerated save setting match default: handle string combination format constructor json_hex_amp possible seconds ssl soap size entries affect bit added combined quickhashinthash::hasher_jenkins1 matched functions following several memory uids immediately openssl_zero_padding turns message quickhashinthash::check_for_dupes 50 remove json_force_object specific wnohang either timeout contain indices json_unescaped_slashes | associative function ignored set namely eventsslcontext::opt_* 19200 rrd quickhashintstringhash::check_for_dupes rate sure export 110 query contains fileinfo pgsql_conv_opts event page autocommit provided following: gmp_native_endian actor 38400 since idna_error_* current buffer written option: quickhashintstringhash::hasher_jenkins2 arrays cp_uid pgsql_dml_exec intlchar::fold_case_default consisting restoring ft_uid available profiling hash pathinfo_filename msg_number 300 idna_* msgno given quickhashintset::hasher_jenkins1 mailbox st_uid \seen crlf quickhashstringinthash::do_not_use_zend_alloc pathinfo_basename optional quickhashintset::do_not_use_zend_alloc takes $value pairs ft_peek updating inheritance pgsql_dml_async treated messages pgsql_conv_force_null specifing connection prefetch context specification passing makes options quickhashinthash::hasher_jenkins2 ignored_functions pathinfo_dirname specifies already dont well op_readonly hyphen within number one pgsql_conv_ignore_not_null canonicalize apply array open quickhashintstringhash::hasher_jenkins1 read-only uid use php additional script quickhashinthash::hasher_no_hash sequence system wrapper decode json exited treat statement ed quickhashintstringhash::do_not_use_zend_alloc systems baud openssl_raw_data option mostly quickhashintstringhash::hasher_no_hash update listing flags pthreads_inherit_all argument flag pgsql_conv_ignore_default quickhashintset::check_for_dupes child xport removed options: document specify must intlchar::fold_case_exclude_special_i constants) wait3 default database single value json_pretty_print quickhashintset::hasher_no_hash values json_hex_tag behavior json_unescaped_unicode ft_prefetchtext property are: delete 150 cp_move 600 include: json_partial_output_on_error attribute pass 1200 bitwise uri libxml numbers json_numeric_check return element tells returned containing pgsql_dml_escape zero json_hex_apos provide json_preserve_zero_fraction gmp_msw_first bitmask db2_autocommit_on port also valid 5 bsd-style copying instead 4800 parameter json_hex_quot duplicate 200 used may see rfc822 keys db sets conversion aggregation 75 two characters quickhashintset::hasher_jenkins2 disjunction class constants man 9600 attempt 1800 eventbufferevent::opt_* = mask z39 refresh without passed command specifying allow searched op_anonymous starting se_uid unset phps
$fontid	font identifier used
$dbx_result_info	info field columns provides types names
$composite	composite operator image
$cascade_max_cand_epochs	epochs max candidate
$service	string identifier name service internet
$server	information containing hostname ip mysql server picked basic array
$fk_table	table key foreign
$eventcb	callback status-change event
$faultstring	message soapfault error
$image	functions object resource returned imagecreatefromgif() haruimage image creation containing compare one instance imagick valid data string imagecreatetruecolor()
$percent	calculate third similarity percent similar_text() argument passing reference
$old_password	password old
$cutoff	control performance used advanced
eventconfig	object eventbase
$colorspace	transparentcolorspace color rgbcolorspace image hslcolorspace undefinedcolorspace one yuvcolorspace ycbcrcolorspace srgbcolorspace ypbprcolorspace perform reduction ycccolorspace transformed ohtacolorspace graycolorspace hwbcolorspace colorspace: constants xyzcolorspace e colorspace yiqcolorspace cmykcolorspace typically
$mongoclientconn	connection database
gmagick	chopped comment defined image blurred gmagick noise enhanced equalized flipped border self cropped annotation drawn embossed charcoal added object corrected framed compositions made success simulation gamma
$protocol	stream_ipproto_raw lowercase used protocol returned communicating stream_ipproto_udp used: within specified udp tcp specific stream_ipproto_ip stream_ipproto_tcp either domain sets stream_ipproto_icmp parameter socket
$variables	available map variables php javascript
$kernel	kernel convolution
$num_points	number least vertices 3 total must
$ry	corner direction radius vertical
$rx	x horizontal radius direction corner
$objdesc	descriptor object
$extr_prefix_invalid	variable prefix invalid/numeric names
$function_name	function execute name registered register worker server job override string
$open	shown unequal opening viewer note zero unfolded pdf document open
$gmin	green lower limit
$encryption_key	use used encrypt encrypting plaintext encryption database sqlite decrypting content key blenc optional
$contextengineid	engineid context
$path_from	url current file
$nseconds	seconds number
$clause	sql-like clause
$func	function applied constant group-by attribute value key sets compute order
$num	specifies insert elements records many database number artificial record stored picked entries counting order
$array1_sort_flags	sort_numeric compare dont locale numerically array previous based flags: current change sort_string type sort_locale_string sort argument: types sorting items sort_regular options normally strings
$cascade_weight_multiplier	weight multiplier
$rprop_delta_min	minimum step-size
$compression	bzip-based compression zlib-based remove one add whole-archive phar::gz phar::bz2 must phar::none
$query_is_select	function name storage implementing handler functionality user query_is_select
$create_mode	create_mode specified mode file created
$class_name	set splfileinfo want specified use instance namespace class may simplexml_load_string() parameter splfileinfo::getpathinfo() schema return instantiated simplexml_import_dom() object derived splfileinfo::getfileinfo() know optional properties simplexml_load_file() name created instantiate lowercased splfileinfo::openfile() called exported
$beta	given angle gradient midpoint degrees end
$location	url request
$password	username use null associated users database plaintext omitted random generated authentication encrypt connection used connecting user key pass new password entry
$page	definition harupage clicking destination displayed number instance valid link pdf document page
$column	specifies set number 0-indexed column mapping name field result integer 1-indexed matching string either
$execute	specifies via argument result event completion prototype: passed ; match function returned void modifications following data execute request value callback without mixed
$socket	stream previously numeric connections file ready sockets use necessarily data send socket_accept() valid means may ssl accept representing must resource socket extension created descriptor socket_create()
$octal_string	octal convert string
$xmldeclatation	xml boolean set value declaration
$add_empty	return missing keys value add null
$fetch_style	caller row returned controls next
$algo	use constant algorithm denoting password hashing
$face	fdfnormalap fdfdownap values possible fdfrolloverap
$relation_name	relation name
$left_operand	operand string left
$pub_key_id	openssl_get_publickey() returned -----begin formatted key----- public pem key resource miibcgk example string
$sem_identifier	sem_get() identifier resource returned semaphore
$errorcb	invoke callback descriptor cannot error null
$map	ordering nis pixels exported map
$max	upper fixed maximum random number collection bound records amount elements value gmp representing id store size
$pri	priority: eio_pri_min eio_pri_max request eio_pri_default null
$brush	image resource
$preg_split_offset_capture	appendant set string also flag every offset returned match occurring
$save_path	store/retrieve path session
$cas_token	associated cas value existing item token variable unique store
$cpoint	control gupnp_control_point_new() identifier returned point
$nonce	oauth_nonce value
$dialect	dialect executed defaults default within one supported connection client libraries statement sql highest selects
$old_value	old pointed cache value user key variable
$sql_statement	statement sql
$mxhosts	mxhosts placed list records found array mx
$bits	bits number
$optval	option value
$maxlength(integer)	read bytes maximum
$recurse	recursion enables
$gmagickdraw	operations object render settings text gmagickdraw contains image drawing
$iterator	used iterator infinitely check upon class recursiveiterator traversable iterate filtered copied detach counted append constructed
$stub	use handle string stream executable phar stub open archive
$tag_rules	available containing rules parsing keys see array bbcode_create() associative
$syntax_only	function set name true verifies might method
$title	use title process displayed note header window new
$input_parameters	elements parameters many bound executed values statement sql array
recursiveiterator	parentiterator current recursiveiterator() iterator entry
$one_way	set one_way 1 returns nothing method
$new_cache_expire	given cache current expire replaced new_cache_expire
$padding	openssl_no_padding openssl_pkcs1_padding openssl_pkcs1_oaep_padding one padding openssl_sslv23_padding
$strict	specifies set encoding detection in_array() check use strict also haystack parameter function used needle true types comparison search determines third whether (===)
$array	origin kernel servers key/value affected array element check containing matrix initial add pad test input pixel used return get keys import iterate pool count pairs work value flipped judy values associative
$smiley	found replaced string
$rmax	upper limit red
$msg	buffer retrieved object holding published message sent
$param_val	parameter optional value
$ns	xml prefix namespace uri
$filepath	containing filename relative extracted file directory path absolute
$coordinate_array	array coordinates
mongoclient	database
$mimetypes	additional mapping mime file extensions array type
boolean	invalidate false successfully casted invalidated disabled boolean evaluated file table return script cache state var opcode match hash compiled failure objects nothing password true last success cached value item indication property opcache otherwise
$channeltype	provide valid constant mode channel
$final_callback	function end name user-defined callback aggregate apply php data
$coordinates	coordinate array
$targetencoding	output encoding
$result_array	array since type result converted
$img_effect_normal	img_effect_alphablend
$statement_proxy	object mysqlnduhstatement mysqlnd proxy statement type
$module_name	name module
$cost_rep	replacement cost defines
bool	code iterator switched global results query children row send 0 alphabetic siblings nodes indicating digit lack string reopened lowercase every exitsts level list large item dir built-in alphanumeric index sub directive current public version ; method metadata hash objects compressed others apache path safer strong change obtained yaf_config_abstract returns: queue prior cert usually options via class_name private visible boolean traversing use working contains readable two handler call setcookie() type thread-safe sort successful outputs acceptable occurred memcache name= none graphic word modified descriptor sent exceptions example control stream process lock codepoint effectively tag something cloneable allowed occur returned end namespace method_name parameter map blocks description may wrong fd date horizontal data response entry sets element callback algorithms definitions installed disabled isnt including still pointer perfect 1 succeeds actually better platform lu mail interface_name within return records buffering matched represents document name always decimal identified win32 read/write mode timeout found identifier square fired namespaceuri unlock used static measurement mongoid programmer event try/catch opened space contained newly supports occurs dictionary standard non-multithreaded thrown pairs created deprecated could creates iso hexadecimal throws first already encoding symbolic number one aggregate blank reached array open size given reference service caught consisting 2 passed white final store statement svmexception exactly var transaction connections enabled determined doubly false turned spelled encrypted null linked option built depending self instance internal flags = needle normal printable gmagick object callable regular connected letter position pair acquired class released request uri part wildcard pattern text yaf_route_regex::_construct() session access busy parameters implementation cache terminal failed --enable-debug handle closed cannot secondary closure cached bytes calling crc slaveokay declared set exists locale module writable result fail fails clearing currently bidi_mirrored filename state encase tainted correctly neither magic_quotes_gpc server_hash available 24 key interface according connection attributes otherwise point color corresponds active compile-time loaded java addition expected empty > direction route else child former case exception value cursor error property thus equal cant binary verified punctuation archive member html arguments finite status extended updated upon running uses user characters infinite php task database phar exited client command filesystem termination white_space timezone_identifier stored kill unicode mysql yet previous character capabilities passive parents permissions match read jste integer accepted success variadic signal server indication either output accessible tar/zip uppercase successfully library added specified images autocommit samconnection operation gearman warnings legal exit compression/decompression icu refer run deleted executable host run-time socket extension range messaging block previously float bound matche doesnt lob rows additional val start forward function creation attempted registered lint delivery failure link alive heap removed true longer child_terminate whetehr default table_name iterated problem function_name constant defined weakref::get() parser replica exist file check file/directory storage field valid bool test node requested elements iterators variable configs pool whitespace e eof algorithm assume code: persistent strings write directory 200; original
gmp	raised square false random number exist absolute inverse representing sum next 5 arguments new gmp return greater complement failure ones integer php remainder prime resource success value portion root
$jday	julian operate day
$get_stats	function get_stats name storage implementing handler functionality user
$throw	specifies whether autoload_function registered spl_autoload_register() cannot exceptions parameter throw
$filehandle	handle returned write images file fopen() filehandle
$initialval	initial value semaphore
$construct	use object anonymous constructor
domnodelist	function preorder containing elements xpath domnodelist tree given object order instance traversal matching element new nodes encountered expression class matched
$acctstr	db2 used string using database character sql_attr_info_acctstr host client null-terminated connect accounting identify server pointer sent
$size	values: max harupage::size_b4 harupage::size_b5 contiguous within number one connections array font lists size harupage::size_executive harupage::size_a3 bucket create able length expressed read memory shared chunk harupage::size_a5 harupage::size_a4 terms configure truncate harupage::size_us4x6 buffer harupage::size_us4x8 harupage::size_legal collection pools harupage::size_comm10 new execution pixels pool must harupage::size_letter task desired wish required bytes maximum fetch token future items following amount fixed workers block harupage::size_us5x7
$xray	x direction ellipse ray
$width	trim chopped neighborhood defined image number surface scaled stroke arc border ellipse defines raise width pattern size virtual terminal source window template units new device-space local pixel columns return returned aread desired exported line extracted e target region area lines thumbnail record points rectangle page
$charset	specifies represent set omitted searching one result iconv assumed charset character parameter used string use mime represented encoded optional constants sorting name database default fribidi_charset_xxx z39 connection str strings
$dict	dictinaray resource dictionary
$quickprop_decay	factor decay quickprop
$character_set	set determines character client libraries used oracle
$env	current use php run passed process variables pairs environment may set command env target array null associative name/value
$typemap(array)	map configuration type
$end	search end sequence reaching upon value ending ended arc degrees position rotation angle
$out_fd	resource socket stream descriptor file output
$fields	wildcards one export names slops array boosts slops] describing space field parameter separated optionally return format insert supports database arrays fields list values [,
$gupnp_type_double	variable double type
$cascade_candidate_change_fraction	cascade fraction change candidate
$rmin	lower limit red
$oauth_auth_type_uri	oauth request parameters append uri
$session_name	session name
$parameter-type	parameterdb2_param_out, constant output whether accepts bound parameterdb2_param_in, returns outputdb2_param_inout specifying sql variable input php parameter
$qmanagername	queue manager name
$timeout	specifies operations supported msec number accept second value replies event unit miliseconds network subsequent system 0 call passed units connecting receiving parameter milliseconds used defaults seconds microseconds override optional response subscription daemon socket sets default deprecated interval wait server millionths connection timeout time connect() first
$blackpoint	image black point
$join	harupage::round_join harupage::miter_join values: one harupage::bevel_join following must
$escape	set optional escape character one field sets parameter
$cas_tokens	cas items tokens variable found store
$grp	resource group request returned eio_grp()
$opt	curlinfo_namelookup_time code requested enabled number one curlopt_followlocation curlinfo_starttransfer_time file total establish complete redirect start unknown manually next curlinfo_total_time seconds redirects option steps curlinfo_connect_time document redirection started curlinfo_filetime http returned curlinfo_redirect_url may retrieved transfer took curlinfo_effective_url remote byte curlinfo_redirect_time curlinfo_pretransfer_time begins received transaction last name effective url curlinfo_redirect_count resolving transferred final connection -1 constants: time following found disabled: curlinfo_http_code first
$commitwithin	auto within number commit document milliseconds
$property_value	new value
$secret	host server secret passed shared parameter
$maxanalyzedchars	regex maximum number field characters fragmenter using analyze
$addr	10 domain socket form ip contain number unix ipv4 address path optional port string
$stream_or_context	apply parameters context stream
$llx	corner lower left x-coordinate
$lly	y-coordinate corner lower left
$filename	pointing clear_realpath_cache jpeg stored bytecode relaxng font saved yet xml write monitored writes cache source add valid touched input save uploaded gd2 string returning read compiled rng resolve resource name config seperated resolv remove specific gd outputdata output mp3 num_train_data set dump requested rrd relative added pass array in-memory network space rpm filename import inputdata scheme:// full hash symlink blob/clob path created num_output pdf thats load note image symbolic number raw message wbmp use checked 2 num_input store schema function :memory: form clicking tested train link pwl true png fdf wish neural appearance maximum format: following profiling bzcompressed sqlite file stream attribute specified phar postscript libxml neurons ini want parsed paths containing open rather mib archive highlighted also html holding instead document parameter unescapes realpath stat used information may php data class opened exe e database clear uri directory definitions model
$input_vector	scaled input vector
$ray	circle arc ray
$spkac	challenge expects signed valid key public
$file_extensions	argument comma paths built appended filename current returns include checks separated filenames class lowercase name default list calling without extensions contain simply
$rewrites	function return string passed false rewrites parameter must
$first	string first
$repos_url	retrieve log repository url item history
$degrees	angle rotation degrees
$skip_results	whenever skip results
$sx	ordinate x starting rectangle bounding
$sy	ordinate bounding starting rectangle
$retry_interval	15 often default seconds controls server failed value retried
$closure	bind functions anonymous
$want_peer	set remote socket local name false true returned
$fill_opacity	opacity fill
$pattern	specifies hierarchy text searching shell names query pointer containing pattern start arguments files extended insensitive string mailbox regular stick matched case search name glob() posix wildcard property expression
$sh	handle curl share returned curl_share_init()
$normalize_array	normalize color values
$sd	degrees rotation starting
$readcb	invoke desired read callback null data event
$entity_name	defined name entity
$localname	node elements retrieve name zip xslt attribute inside move filename supplied next create override entry parameter local archive match prefix:tagname
$recpos	used greater records may optional database number current record parameter specify
int	code intlchar::char_category_currency_symbol iterator issued global results month pcntl_sigwaitinfo() radix consists query disk row nested 21st send 0 intlchar::char_category_final_punctuation resources mysqlnd_ms_query_use_master division digit returned activation replication entries ip_address entire level correct large item vector -1 -3 dotnet intlchar::property_invalid_code servers upper revolution occurrence xincludes rrd built-in zero initialized port index errors imported intlchar::char_category_control_char section selected current deleted version channel quickhashinthash new ; public full hash respectively component french desired objects active 100 change wait intlchar::char_category_end_punctuation search inotify handlers checksum error: larger truecolor example bitmask intlchar::char_category_lowercase_letter aka quickhashstringinthash dbplus_err_wlocked exited quotient named filepro explained sqlite unix api intlchar::char_category_modifier_letter total select ncurses use wand would positive intlchar::char_category_uppercase_letter negative substitutions interlace call cairoformat memory shmop_open() type milliseconds intlchar::char_category_other_number sessions successful descriptors occurred row_b[$column_key] flag revents none join anything modified descriptor judy values constants: following modifier could intlchar::char_category_other_punctuation nearest intlchar::char_category_surrogate stream process pcntl_sigtimedwait() codepoint substring indicates minimum performed cursors unhandled string information respective ingres_num_rows() str2 str1 e_warning uncompressed 1 sunday possibly beginnning parameter inputs row_a[$column_key] may watch spot collection fd date data response constants baseline entry effective decoration_ element cascade representation 0-indexed preg_backtrack_limit_error disabled main_str pointer non-zero delay style group c succeeds writing systems might < pending within return greater seeking matches timestamp solrquery::facet_sort_count) intlchar::char_category_format_char scene records gz-file buffering day bigger matched represents execute gets name cubrid decimal fonts odbc sphinxclient::runqueries win32 filling mode timeout found entirely identifier retrieve megabytes weight pgsql_transaction_idle chunk numeric started frequency year mongoid operation event predefined termination network -4 quality gmpnumber contained newly occurs indicating fam_next_event() pcre oid solrquery::facet_sort_index dictionary variant activity base php_session_disabled conflicts region byte beginning compression training thread created imagick messages days timer times stride length signature throws first intlchar::char_category_connector_punctuation intlchar::char_category_combining_spacing_mark fetched features ignored snmp variables number oracles one smaller another owner array ftp_finished open size given levenshtein-distance service unknown intlchar::char_category_line_separator win32_no_error system priority 2 master listed statement intlchar::char_category_private_use_char white scheme bits fbsql passed ftp_moredata relative needle intlchar::char_category_decimal_digit_number module representing connections database iteration pdoexception idle classes posix str accessed files false hue julian occupies argument intlchar::char_category_initial_punctuation raw evchild pgsql_transaction_intrans preg_no_error null seek contents option preg_internal_error documents callback latter gravity instance potential command intlchar::char_category_modifier_symbol transparent realpath added warnings buffer chars object directoryiterator pgsql_polling_reading scripts alpha segment class intlchar::char_category_other_symbol preferences especially pgsql_connection_ok filesystem alarm request stream_select() intlchar::char_category_other_letter ticks text supported ending colors session intlchar::char_category_math_symbol font curlm_xxx access highest layout parameters implementation cache inserted intlchar::property_ terminal failed corresponds slob invocation constant local columns handle wide stop cannot shared items represented lobs processes resource fields bytes method arrays processed queries ftp_failed valid left_operand set radius_send_request() exists characters/bytes pgsql_connection_bad mysql roundtrips epochs see radius result outputted fail calendar #0 packed subject palette invoked pattern currently written determined enumerated progress available stagnation profiling intlchar::char_category_space_separator vertical lstat rolled combining mailbox socket_select() bitset key crc32 dividend pixels received hits last extracts wait3-available equal connection context interesting exceeds requests com otherwise space point color logged period height genre learning descent table inode backend erased graphics described int intlchar::getintpropertyvalue() much expected copied empty > db2_scrollable describe corresponding object-id precision else finished input 32-bit general former divisor case exception gmp mongodb\driver\bulkwrite defining polls batch value pixel cursor steepnesses behavior error property mnogosearch loop real changed neuron iv decoration neurons affected pgsql_polling_ok id binary containing intlchar::char_category_paragraph_separator severity descendants amount enumeration archive arguments quickhashintstringhash modification document events status independent used updated closest initialization numerical upon primary allocation uses user characters changing php stack recent transaction operands neural phar intlchar::char_category_titlecase_letter directly flags sets position pharfileinfo result_id self left protocol less storage intlchar::char_category_dash_punctuation i/o stored virtual unicode integer speed previous unique signal candidate also character capabilities arrayobject terminating blob versa usage cairoimagesurface haystack permissions easter remaining match scheduled march format read pgsql_polling_writing intlchar::char_category_letter_number elapsed ticks-per-second listening using bit enums intlchar::char_category_enclosing_mark insert success message user-defined server wnohang either always output security page two specifies pgsql_transaction_inerror right honored iterations sequence uppercase successfully back specified images ascent matching happens delivered scale describing array_or_countable gearman avoid splfileobject::setmaxlinelen() 255 refer expires run directories seconds processing st_dev evloop offset properties postions chapter comparison actual socket pgsql_polling_active column optimized intlchar::char_category_non_spacing_mark pgsql_transaction_active blackness youve block referenced letters intlchar::char_category_char_category_count garbage previously image pgsql_polling_failed child libev rendering appropriate iterate frames old lob rows right_operand errno support initial db++ long custom width filesize var function registered encoder failure xml_get_current_line_number() link line db2_forward_only true sent longer count scrollable throw modifiers default forward-only maximum record limit problem similar display delete dbx_cmp_desc units associated uid defined tokyotyrantexception parser pid direction watcher char intlchar::char_category_start_punctuation exist file curl internal incorrect functions codes dbplus_err_noerr intlchar::char_category_unassigned invalid field setting 5 outputs test intlchar::char_category_general_other_types category stat elements generates provided symbol quickhashintset distance update prepared intent sql included structure opened svm eof algorithm vice resolution required mask depth time directory lzf starting strings
$extensions	available object created registered javascript list extensions context v8js::registerextension() using v8js
$arguments	function containing coordinates distortion arguments pass array method
$allowable_tags	use third tags optional second stripped parameter specify
$genre	genre name string
$ok	set mongocollection possible instance reads replica mongoclient members queries using sent secondary
$suggestions	word suggestions spelled correctly contain variable array
$thumbnail_geometry	e image preferred border thumbnail size
$path	node retrieve pointing image within symbolic relative warning rrd file disk parsed paths executable copy checked opened working callback avoid available system created source valid new newly must local status full invoke binary deleted example) regular link path line mounted data wait remote target database url geoip script commonly shebang#!/usr/local/bin/perl repository item session pathname iterated filesystem directory cookie first changes server delete
$ox	origin x ordinate
$oy	origin ordinate
$callback	code expects converting previous group parameters chosen input defining epochs_between_reports sent case return returned stop period callbacks $item entries resource name fann_get_bit_fail() fann_get_mse() signal user-defined requesting continue timeout $callinfo set iteration contiguous epochs see calling event category invoked network supplied current method fann_train_on_file() progress occurs run desired collation path training equal range mixed requests first number one boolean done shutdown carry apply array yar use takes initial two $carry call function general callbackmixed removed true desired_error fann_set_train_stop_function() maximum value behavior following called false certain ann watcher ready max_epochs null depending holds matching introspection epoch points parameters: instead gets parameter object callable user sql php data response calls neural register request element callback train time every typically
$notification_code	notification stream_notify_* constants one
$op	operator second evaluation pipeline first
domentityreference	new false occurred domentityreference error
$black	dash length
$groupsort	controlling clause optional groups sorted
$simplepost	term default text < highlighted /em sets appears >
$howmuch	write bytes maximum number
$pk_qualifier	primary key qualifier
$lob_from	lob copied
$info	attribute requested used driver cursor_id request maximum value number cursor documents kill batch_size key request_id integer identifier data fetch
$entire_row	returned default value column returns query querysingle() first
$outfilename	decrypted string pem outfilename format specified messages signed persons written stored file output certificates path message holding name
$zend_extensions	return like zend regular extensions listed mysqli
$stream_filter	filter removed stream
$white	length dashes gap
$http_method	e head oauth_http_method_* get request use one put oauth http post includes method constants delete
$zenith	date default:
$operator	relationship third particular argument test specified operator optional
