all	predicate args vectorizing functions flag manipulation polynomial representing class
code	block code "a abstract supported julia walk cube expressions cython generator n-dimensional f2py wrapper generators wrappers printer gray python javascript essentially octave/matlab base uses octave one class represents convert hamiltonian assignments length edge rust subclasses strings code-printing ufuncify
managed	automatically thread old-style separate window assumptions executes pyglet classes metaclass event loop
lerchphi	function phi transcendent lerch
global	changed global_evaluate whenever cache dmp objects polynomial ring cleared true must
trigonometric	functions inverse reciprocal trigonometric base integrals class
scalar	given manifold system symbol/base field scalar base coordinate
attrs	don't certain >>> base sympy attributes class 'inherit'
multiset	count multiset partitions methods enumerate
homomorphism	free domain via homomorphism matrix helper submodule abstract instantiate homomorphisms homomoprhisms expressed concrete base module thereof class quotient
totient	function \phi phi calculate integers positive \lambda 0 number n > \leq smallest reduced_totient totient lambda reduced euler carmichael
piabket	box eigenket particle
cython	cython uses wrapper
undef	function undefined application base resulting expressions class
chebyshevu	chebyshev kind chebyshevu zero 0 :math k <= u_n n nth second indexed kth polynomial x returns root < chebyshevu_root gives
chebyshevt	chebyshev (of kind t_n chebyshevt :math chebyshev_root zero n nth returns indexed kth polynomial x gives root k first
combinatorial	combinatorial functions base class
description	xy-pic information stores description arrow necessary producing
tr	matrix trace generic a) sympy operation
unequality	relation objects unequal two
recurrence	set parent algebra defined operators list polynomials recurrence noncommutative sn base operator intermediate ring coefficients
weyl	lie weyl group semisimple subgroup
swap	gate qubit two swap
elliptic	kind legendre complete third defined m, n, integral two three second arguments elliptic evaluates z called incomplete first
jminus	operator j-
include	polynomial flag include functions manipulation
immutable	create version immutable sparse matrix
deprecation	deprecated warning features sympy
predicate	function predicate applying value returns boolean resulting expressions class
string	xy-pic picture necessary description information ascii arrow stores producing
orthogonal	key orthogonal 'orthogonal' polynomials handler base class
eis	function functions \mathrm{li} helper tractable \mathrm{ei} gruntz make algorithm z
airyai	function airy kind \operatorname{ai} first
sympify	sympification instances trait disallow mix class
li	integral logarithmic classical offset
difference	represents set elements either sets intersection
condition	satisfies set condition given elements
level	dpll represents manager differentialextension algorithm level sound contains enough information single procedure context decrementing backtracking
tanh	function \frac{\sinh hyperbolic tangent x }{\cosh }
manager	properties manage class tensor
discrete	probability etc univariate space serves discrete single superclass variable distribution poissondistribution
vector	manifold used denote instances zero vectorialexpressions expressions whose use basevectors field classes pretty define printer string scalars repr base super class latex e g vectors lambdify deferred vector products components sum
pspace	set probability defined random number single spaces univariate event different space probabilities variable/symbol two singlecontinuousdistribution encode resulting several events independent symbol continuous collection merger variable likelihood represents processes finite continuum consist equal attributed discrete values
piabbra	box eigenbra particle
outer	product unevaluated outer bra ket
segment2d	2d line undirected segment space
accumulation	represent # accumulationbounds accumbounds interval note alias [a closed always b],
point2d	euclidean 2-dimensional space point
upper	'upper_triangular' handler key
coordinate	associated reference frame wrt symbol/base scalar coordinate
acosh	function cosine inverse hyperbolic
fresnelc	fresnel integral c
direct	sum spaces [1]_ direct hilbert
cosh	function hyperbolic + \frac{e^x cosine e^{-x}}{2}
civita	represent levi-civita symbol
zero	domain 0 number denote zero dyadic zeromatrix additive matrix >>> - instance handler import elements dependent 'zero' key sympy infinite class identity matrixsymbol basis vector
pyglet	plot ============= examples
mathieuc	function mathieu c one q cosine z solution
implemented	implementation ideal code modules relying
odd	handler 'odd' key
subclass	don't certain >>> base sympy attributes class 'inherit'
index	dummy tensorindextype name represents index metric contains free abstract handles ones indices class characterized tensor
xor	function exclusive xor logical
sub	domain submodule homomorphism submodules rings modules free concrete base module polynomial generalized ring thereof class quotient
invertible	'invertible' handler key
loggamma	function loggamma logarithm implements gamma
diag	blockdiagmatrix blockmatrix matrices along diagonal
sum	represents sum [1]_ direct polynomial spaces summation unevaluated univariate hilbert roots
nand	function nand logical
fock	sequence many-particle see numbers occupied bra occupation space bosonic particles also state describes bosonbra orbits collection ket hilbert fermionic ======== particle many second quantization fock mode representation
relational	base relation class types
falling	function functions valued factorial double hypergeometric related concrete rising mathematics falling arising
method	kane's functions object manipulation flag lagrange's polynomial method
body	body rigidbody particle body-orienter depending initialization object denote idealized rigid common passed sympy representation class either
full	handler key 'fullrank'
reporter	identical like parent reporter py produce reporters test output class
shobra	bra time-independent sho
component	functions used associated visitor support enumerators internal multiset class partitions
modular	modular representing class integer
inverse	stores monomial symbolic argument simply transforms another unevaluated functions inverse matrix cosine "inverse" object trigonometric hankel base mellin sine representing class order without multiplicative fourier expression laplace
greedy	polynomial functions option greedy manipulation
octave	convert code generator octave/matlab printer octave expressions strings
lex	monomials reversed graded order lexicographic
sine	inverse unevaluated cosine transforms base sine representing class
implicit	representation implicit plot
mult	multiply simply "constant"
preorder	tree pre-order traversal
divisor	function calculate positive k divisor_sigma equal sum([x**k n x integer \sigma_k ]) divisors divisor
genocchi	satisfy integers genocchi sequence g_n numbers
pict	picture ascii
shift	upper lower b index increment decrement
k	kind complete defined integral elliptic first
gens	polynomial functions manipulation gens option
periodic	logarithm represent riemann argument surface quotient
permutation	known represents elements ordered 'arrangement index one-to-one alternatively 'ordering' list arrangement p number' ij permutation operator group defining class
fourier	inverse fourier sine/cosine represents series base gates transforms quantum unevaluated representing class superclass
options	polynomial manager options module manipulation
quotient	elements commutative submodules modules rings free element submodule module ring representing class quotient
golden	golden ratio \phi
named	represents name morphism
satsolver	theory capable solver boolean conjunctive finding model representing class sat
cbrt	function represents cube root
julia	convert code generator julia printer expressions strings
boolean	operations singleton via false booleantrue assigned boolean sense space make version sympy function used option equivalent object base lives booleanfalse true class must value etc logic accessed
decrement	decrementing manager differentialextension context level
kanes	kane's method object
imaginary	q handler \sqrt{-1} imaginary = unit
unit	represents set unitsystem coherent \sqrt{-1} units imaginary = unit
plot	plot central intended parent displayed module plotting examples base objects grandparent ============= class modes
positive	'positive' handler key 'positive_definite'
contains	x set examples asserts element
negative	key='negative' ask() less number strict one test zero negative infinite expression called quantity
flat	transfer reflection refraction matrix ray
hilbert	mechanics product tensor space abstract exponentiated [1]_ direct spaces sum quantum hilbert
handler	useful methods ask() 'square' number zero boolean inherit query defines 'orthogonal' 'diagonal' 'odd' complex wrapper strict handler 'unitary' rational test 'fullrank' real prime 'commutative' antihermitian 'positive_definite' 'upper_triangular' 'finite' 'symmetric' less algebraic 'zero' base allowing key ask integer imaginary class must 'prime' represents 'invertible' extended_real key='negative' handlers 'lower_triangular' hermitian value q common truth expression called 'positive'
mathieusprime	function mathieu sine q derivative z s^{\prime}
factorial2	integers (n!)! n!!, factorial double confused nonnegative defined odd
type	contains simple certain metric registers transforms information different tensor things holds actually languages cosine series algebras type creating lie hankel base sine class types tensorindextype name datatype strings constructor fourier options characterized
reorder	exception limits dependent raised trying reorder
sort	sort polynomial functions option manipulation
lowering	operator lowering 'a'
on	function represents intended remains classes free boolean superclass predicates unevaluated define
composite	represents functions e option g composite class domains base x zz manipulation polynomial zz[x], morphism composition morphisms
flag	flags base kinds class
entity3d	3-dimensional linear euclidean space entities base line segment class ray
line3d	infinite line space 3d
getter	values subsequence return class helper
shoop	operators base class sho
idx	represents index expression integer
f	kind legendre defined integral elliptic incomplete first
dep	mechanics general state base time-dependent quantum ket class bra
erfinv	function erfinv defined inverse error
erf	function defined gauss error
printing	default implementation printing classes sympy
del	mathematical represents symbol differential 'nabla' represented vector operator expressions usually
thin	lens transfer thin matrix ray
im	function returns part performs imaginary expression
root	chebyshev represent simple <= zero polynomial univariate roots lie sum system 0 returns complex chebyshevu_root indexed < algebra chebyshev_root nth every unique represents kind k second n kth root first
mx	x mock-up gate measurement
mz	gate mock-up z measurement
wedge	forms wedge product
llvmjit	convert llvm ir expressions
drawer	xy-pic given corresponding produces :class diagram diagramgrid, representation
assumptions	assumptions set representing
cartan	creating etc things actually concrete base cartan constructor class types a4
legendre	p_n legendre degree [-1 orthogonal :math 1] p_n^m polynomials n nth assoc_legendre respect polynomial x order expression , related gives
tan	function tangent
unevaluated	function represents unless intended remains classes define evaluated released boolean free predicates unevaluated expression superclass
axis	axis class orienter denote
atanh	function represent inverse 1], hyperbolic == )/sqrt tangent atanh(sqrt hyper([1/2 [3/2], z z)
csc	function cosecant
pair	pair represents expression condition
pure	polynomials representing class pure
gate	unitary reduce qtf phase single operator acts two wrapper r_k black non-controlled gate swap box qubits base hadamard class identity controlled-not circuits scalar value qubit
parameter	matrix transfer gaussian representation formalism ray
sin	function sine
fp	would relators equal list/tuple freegroup fpgroup take way specified
idft	discrete inverse transform fourier
product	wedge domain stores finitedomains probability monomial symbolic argument see spaces simply expressions unevaluated elementwise orders bra 1 cartesian outer tensor space merger support two forms also without inner products several consisting arguments independent product object continuous collection built input ket matrices hilbert matrix represents finite [1]_ n vector resulting [1] sets domains x order dot
frac	function multivariate functions real option represents defined auto fractional distributed element field part numbers rational manipulation polynomial x [1]_
mat	sum product matrix expressions
atan	function inverse tangent
algebra	set algebra :math noncommutative polynomials recurrence operator intermediate sn dx polynomial ring ore base coefficients
max	list return possible value maximum
collection	use meijer g origins holds collection formulae class
expectation	expression symbolic expectation
diagram	category represents given corresponding produces certain xy-pic holds constructs :class diagram diagramgrid, fitting grid representation
levi	represent levi-civita symbol
plane	flat plane two-dimensional surface
mixin	adding capabililty class mixin evalf
asech	function inverse secant hyperbolic
data	deprecation rely holds warnings may certain versions different strings languages datatype without experimental sympy future class change
a	upper b index simple series contains information lie increment decrement algebras class
wgate	algorithm n grover's w gate qubit general
sech	function e^{-x}} hyperbolic \frac{2}{e^x secant +
sq	second base operators class quantization
sp	real fortran single literal precision
epath	using expressions manipulate paths
znm	real spherical defined harmonics
element	real domain distributed module stored directly polynomial ring commutative data create rings field freegroup complex rational function multivariate elements tuple free base representing class represents used element wrappers quotient
atan2	function taking \operatorname{atan}(y/x) two atan2 computes arguments x
si	sine integral
block	composed represents blockmatrix smaller matrix code object diagonal supported assignments blockdiagmatrix stored accessed sympy part matrices along block submatrices
ufuncify	wrapper ufuncify
order	upper graded monomial reduce module another polynomial orderings orders index functions based built cancelling lexicographic "inverse" function product option reversed zeroth term base manipulation class represents lower characterizes limiting behavior monomials order
operations	operations matrix shape elementwise provides basic
polyhedron	polyhedral represents group psg symmetry
acsch	function inverse cosecant hyperbolic
wigner	function elements wigner matrix wigner-d rotation d-function gives
ite	clause else
entity	linear n-dimensional space euclidean entities base line geometrical segment class ray
symbols	symbols polynomial flag functions manipulation
mlprinter	prints mathml language whenever presentation markup use possible content tries expression
vectorize	function generalizes scalars taking accept arguments multidimensional
symmetry	parameters tensor symmetry monoterm
csch	function e^{-x}} hyperbolic \frac{2}{e^x - cosecant
ugate	set target general specified gate targets matrix
boson	dagger sequence creation numbers operator satisfies bosonic bra occupation 1 state particles [a describes bosonbra == collection coherent base ket ] class particle many annihilation fock mode fockstateboson(ket/bra)
gen	c code generator abstract functions julia gen fortran flag generators octave manipulation polynomial 95 class rust
primenu	prime calculate factors distinct positive number n integer
window	thread separate window executes pyglet loop event automatically
coth	function \frac{\cosh hyperbolic cotangent x } }{\sinh
airyaiprime	function kind \operatorname{ai}^\prime airy derivative first
jacobi	\beta\right)} :math p_n^{\left(\alpha n polynomial beta alpha jacobi x nth gives
derivative	lie given covariant operator symbols field carries vector base derivative differentiation respect expression
point3d	euclidean 3-dimensional space point
non	raised within integral one another elementary commutative indicate subroutines handler integrated nonelementary function used didn't 'zero' key represents exception algorithm risch property expression
greater	use used intended may strictgreaterthan subclass general _greater greaterthan representations class inequalities
parabola	parabolic geometryentity
yn	spherical function second bessel kind
python	integers printer interpretation integer python python's number field int converts rational type based ring finite expression
auto	polynomial auto flag functions manipulation
sqrts1	z) return 1/2 [1/2], - a], hyper([-a representative
sqrts2	return representative
half	number rational 1/2
not	function use return creating called negation logical iterable() instances returns statement supposed mixin false true class
rotation	operator terms wigner angles euler
nor	function logical
heaviside	separated partial strategy. functions additive piecewise [x [*]_: choose function separation ] properties heaviside f equation differential list u following x z original
ynm	spherical defined harmonics
term	efficient representation coeff*(numer/denom)
equality	objects relation equal two
mcode	python convert printer expressions
hamiltonian	operator hamiltonian
merge	function fortran merge
quintic	quintics functions solvable special
inequality	types *than internal class base
l2	functions square space interval integrable hilbert
mode	modes parent class grandparent plotting intended
arrow	xy-pic information stores description arrow necessary producing
gmpyrational	based field gmpy rational mpq class
subset	subset represents object basic
domain	domain set zz[x], finitedomains finiteset symbol/set simple variables symbols variable single intervals zz polynomial expressions element univariate functions merger restricted support two also take resulting several roll independent *single* option composite symbol continuous collection base manipulation represented using class condition qq represents finite e finitedomain g die interval attached see abstract consisting possibilities discrete values randomdomain arbitrary domains x example
square	'square' handler key
ei	integral exponential classical
xypic	xy-pic given corresponding produces :class diagram diagramgrid, representation
series	objects series surface three polynomial expressions contour surfaces plot containing sine/cosine two implicit sympy consisting 3d function power functions flag base manipulation line data class formal represents parametric lines 2d range stuff representation fourier expression plotted
reduce	cancelling upper lower index reduce order
gaussian	polynomial functions manipulation gaussian option
ket3d	eigenket position cartesian 3d
operator	set dagger defined :math unitary polynomial second weyl simply operator u*dagger ring satisfies index functions "constant" ij * recurrence 1 intermediate identity d/dx elements parent algebra == operators polynomials noncommutative dx multiply hermitian ore representing class coefficients applied represents e h quantum differential list non-commuting quantization p base u sn permutation op
parametric2dline	two expressions sympy representation line range parametric consisting
px	cartesian eigenket 1d operator momentum eigenbra
ring	domain submodules int distributed module general polynomial ring submodule based commutative representing python's rings generalized type multivariate elements gmpy's free mpz objects integer true class represents dmf modules dmp base quotient
out	initialized inoutargument never routine
category	category abstract
xbra	position cartesian 1d eigenbra
twave	one transverse space simple wave dimensional travelling sine
meijer	represents lower b meijer g upper index g-function holds collection increment formulae formula decrement class
matrix	operations represent matrixslice submatrices shape stored expressions cache >>> sympified sympy immutable every using matrices shaping represents large sparse small smaller methods house zero superclass matrixexprs matrix expressed version provides import supports method matrix-like linear diagonal implementing objects represented along properties matrixsymbol off-diagonal deprecated creates base implement expression can't lambda composed via symbolic number homomoprhisms blockmatrix additive transformations 0 transfer create behaves wrapper listed basic diagonalmatrix function determinant blockdiagmatrix part must minimum formats accessed providing subclasses extracting helper abstract elementwise zeromatrix different - functionality ray arithmetic elements though symbol object class identity required representation
factors	efficient representation f_1*f_2* *f_n
rep	represent 1-z 1], [], asin(sqrt "hyper )) a], hyper([1/2 1/2], **a [2*a], log hyper([1 [1/2], - sqrt 1 /sqrt -z*hyper([1 [2], )/sqrt cos(2*a*asin(sqrt log(1/2 return z) == hyper([-a], base representative [3/2], class 2], [2 -a], 1/2 functions" atanh(sqrt /2) hyper([a 2*a*z*hyper([1 representation -z/4*hyper([3/2 z + hyper([-a
tgate	pi/8 gate single qubit
f2py	uses f2py wrapper
re	real function returns part performs expression
uppergamma	function upper gamma incomplete
rational	behaviors abstract number general (p/q) numbers size q based field handler rational probably type define rationals integers python derived base class must represents fields specific p classes attributes
formula	represents use holds based g origins sequence g-function hypergeometric collection meijer formulae formula class
rcode	code convert printer python r expressions strings
math	prints mathml language whenever presentation markup use possible content tries expression
rk	qtf gate r_k
log2	logarithm represents z) log(1/2 1], represent function + - two sqrt 1 == base 2], /2) -z/4*hyper([3/2 z [2
linear	3-dimensional linear n-dimensional space euclidean entities base 2-dimensional line segment class ray
log1	represent z) == - 1 -z*hyper([1 log [2], z 1],
args	predicate vectorizing representing class args
diagonal	elements matrix 'diagonal' m, create behaves diagonalof diagonal off-diagonal handler represented key diagonalmatrix though expression equivalent
free	domain boolean abstract number module infinite stored superclass directly polynomial ring unevaluated elements ray group matrix space remains transfer create api freegroup generators generalized input finite define function used intended tuple free base thereof predicates data class represents homomorphisms modules element concrete classes quotient
standard	etc concrete base a4 class types cartan
hankel	inverse hankel base transforms unevaluated representing class
base	mechanics represent manifold objects tuples series abstract functions related denote states polynomial scalar sequences operator respect array dyadic surfaces information given tensor covariant spin contains rings system actually field stuff generalized pauli routine indexed derivative indexedbase bessel plotting 3d core elements general intended parent "outgoing" operators object component containing stem exceptions base airy arguments symbol/base data class takes bras modes mathieu quantum vector bessel-type spherical coordinate differentiation kets sigma care plotted
mathieus	function mathieu z solution one q sine
shi	integral sinh
ask	ask() 'square' number zero 'fullrank' 'orthogonal' 'positive_definite' 'odd' complex strict handler 'unitary' rational test real prime 'commutative' antihermitian 'diagonal' 'upper_triangular' 'finite' 'symmetric' less algebraic 'zero' base key ask integer imaginary class must 'prime' represents 'invertible' extended_real key='negative' handlers 'lower_triangular' hermitian inherit q expression called 'positive'
expm1	function represents minus exponential one
dirichlet	function dirichlet eta
erfs	function gruntz helper tractable make \mathrm{erf} algorithm z
g	g-function meijer
geometry	also exception parent geometryentity geometry (compatible raised module geometrical entities base sets sympy classes class
deprecated	methods house matrix class deprecated
round	rounding functions base class
erfc	function defined error complementary
w	function inverse lambert [1]_ defined \exp w z
exp2	function represents base two exponential
linearizer	holds form object dynamic system general model
exp1	constant e
erfi	function defined imaginary erfi error
lambda	represent certain used converts facts expressions expr' workaround better way function printer get x interface python's represents expr rcall lambdify 'lambda similar strings lambda
ndim	======== examples
singleton	singleton s) classes registry (accessible metaclass
probability	expression symbolic probability
list2dseries	representation line points list consisting
symbolic	information format contains symbolic system motions symbolicsystem equations class bodies
number	represents kind useful often number a^dagger*a write algebraic simply numbers operator sympy representing class
rank	handler key 'fullrank'
one	predicate args base exactly negative number single unitary holding gate qubit one representing class
entity2d	linear euclidean space entities base 2-dimensional line segment class ray
array	======== examples
cartesian	coordinate represents 3-d system space
reference	mechanics frame classical reference
hyperbolic	functions base class reciprocal hyperbolic
dft	discrete fourier transform
adjoint	matrix hermite adjoint transpose conjugation hermitian conjugate expression
system	represent set dimensionsystem symbolic motions information dimensions contains system unitsystem simple units transformation format coherent every symbolicsystem unique equations class represents algebra lie logic coordinate root bodies
wrapper	wrappers independent code cython testing backends object f2py wrapper used minimum functionality base uses providing class matrix-like ufuncify
piabhamiltonian	box operator particle hamiltonian
checker	outputchecker compared class stdlib
assumption	supported keys contains ask class
expand	polynomial functions option expand manipulation
isign	fortran intrinsic arguments integer sign
airy	airy abstract base class functions
parametric3dline	two expressions sympy representation line range parametric consisting 3d
power1	return z) == [], - hyper([-a], 1 representative z **a
fma	multiply represents add" "fused
ceiling	function ceiling less argument value returns smallest integer univariate
option	registers kinds option boolean equivalent value options assigned base type class must
tuple	around tuple arguments object well subclass actually tuples builtin base wrapper basic differentiation works class care takes
groebner	represents groebner reduced basis
exactly	predicate args exactly one holding representing class
ray2d	semi-line direction space point source ray
j2op	operator j^2
sign	real expresssion sign returns complex expression
than	representations class inequalities
lucas	satisfy lucas recurrence relation numbers similar
std	specialised kind rules factkb built-in use objects basic
kind	function fortran kind
b	index decrement lower increment upper
expr	operations represent transformations sequence abstract pair superclass sequences expressions matrixexprs matrix unless linear parent object atoms algebraic base represented matrices class condition tensor represents released notes evaluated exprs expression
power2	1/2], [2*a], - representative hyper([a return z)
mobius	function mÃ¶bius natural {-1 0 defined follows 1} number maps
str	vector printer string -- repr see internal sstrrepr expressions
minus	operator parameters sigma minus pauli
and	function logical
false	singleton via false version accessed sympy
tids	deprecated use class
runner	used run accumulate statistics doctest test cases class
argument	logarithm represent never name data abstract routine argument surface outputargument riemann always initialized inoutargument type structure quotient
ygate	gate single qubit
anp	algebraic dense number polynomials field
conjugate	argument returns complex ref[1] conjugate
curved	matrix transfer reflection surface refraction interface curved ray
any	predicate vectorizing representing class args
ray	semi-line direction matrix space transfer point source base representation geometric formalism class ray
lie	lie vector respect field derivative
angle	body orienters super-class space
orienter	body quaternion-orienter body-orienter orienter space super-class denote orienters classes class space-orienter axis
min	list minimum return possible value
vectorized	function return vectorized sufficiently lambdified smart
zop	cartesian operator systems coordinate z 3d
ideal	code implementation abstract modules relying ideals ideal base class
generalized	polynomial ring objects generalized dmf
indexed	mathematical represents contains represent test variables object integration stem indexed base experimental indices array indexedbase class elements
modulus	polynomial functions modulus option manipulation
reversed	monomials reversed order graded lexicographic
continuous	domain probability defined symbols represented single intervals superclass univariate event space restricted support singlecontinuousdistribution independent normal/exponential/uniformdistribution symbol continuous collection variable using likelihood represents continuum consist interval serves etc spaces domains distribution
trace	represents expression matrix trace
asin	function inverse sine
airybiprime	function kind \operatorname{bi}^\prime airy derivative first
object	category plot kind objects abstract object displayed base class
algebraic	fields number q algebraic handler numbers key sympy representing class
beta	kind legendre integral eulerian beta called first
regular	regular polygon
assoc	operations laguerre :math related polynomial commutative , returns parts generalized gives degree separate nth noncommutative l_n p_n^m assoc_legendre n x expression order associative
chi	integral cosh
phase	phase gate single qubit
line3dbase	base lines class 3d
segment	line undirected segment space
class	imports functionclass registers cyclic sense avoid namespace subclass needed handler sympy set-theoretic = function registry[c] problems base class kind handlers type register classes
dummy	count dummy used index backends testing identified symbols >>> independent internal import sympy unique class
xop	operator position cartesian 1d
doc	given relevant run object docstring doctests accumulate contained used doctest docstrings test statistics cases extract class
tautology	tautology reporting detected prover internal uses
evaluator	deprecation rely warnings may versions without experimental sympy future class change
part	functions used associated visitor support enumerators internal multiset class partitions
polygamma	function log(gamma + n 1 returns polygamma diff z
exp	function represent exception documentation sphinx exponential number' e^x :math g-function use raised see internal 'polar _get_coeff_exp
parenthesis	tokens representing parentheses list expression
theano	computations theano code printer
sigma	unitary sum([x**k divisor_sigma quantum two-level operator udivisors bra ket calculate parameters positive system class pauli function base \sigma_k^* integer \sigma_k divisors divisor ]) k equal n udivisor_sigma plus x z sigma minus
dot	product two n 1 vector x input matrices dot
quantity	quantity physical
hyper	represent 1-z 1], defined series [], asin(sqrt "hyper )/sqrt log(1/2 a], hyper([1/2 summation return **a [2*a], log hyper([1 [1/2], - sqrt 1 /sqrt -z*hyper([1 generalized rational [2], function cos(2*a*asin(sqrt hypergeometric terms z) == hyper([-a], base representative ratios successive [3/2], )) class 2], [2 1/2], -a], 1/2 functions" atanh(sqrt /2) hyper([a 2*a*z*hyper([1 representation -z/4*hyper([3/2 z + hyper([-a
meijerg	inverse meijer defined g-function integral transform mellin-barnes mellin resembles type
random	represents set probabilityspaces represent variables random value symbols also see values take sympy expressions symbol principle
zket	quantum ket system two-level
xgate	x single qubit gate
naturals	represents natural integers positive 1 numbers counting starting
lowergamma	function lower gamma incomplete
iqft	quantum inverse transform fourier
sinasin	represent z) 2*a*z*hyper([1 + - 1 a], [3/2],
principal	logarithm represent riemann polar number surface branch quotient reduced principal
symmetric	tuple's represents functions set stores option upper handler separate manipulation 'symmetric' lower symmetric indices elements either key sets polynomial intersection
ratio	golden ratio \phi
parameters	takes actually tuples base arguments differentiation class care
true	singleton via version accessed sympy true
cache	derivatives functions cached cache list different formats small expressions matrices store
failed	met raised conditions weren't solver's
abs	return argument value absolute
dict	around object well wrapper builtin dict subclass basic works
pretty	optimizing printer knows extension applications double signs minus 2d stringpict ascii-art vectorialexpressions converts pretty basic figure expression class math
circle	circle space
cgate	control unitary qubits simplifications allows general version gate cgate
cosasin	represent cos(2*a*asin(sqrt -a], == [1/2], )) hyper([a z z)
triangle	sides vertices polygon three
qasm	form qasm lines >>> objects sympy class
dependent	denote instances scalar containing zero basis sum expressed denotes instance functionality mul dyadics product dependent quantities cannot super class vectors base- base common quantity
repr	vector printer string -- repr see internal sstrrepr expressions
beam	load bending resisting matrix capable transfer formalism gaussian element beam primarily representation ray withstanding structural
new	elements supports sympified can't
shaping	submatrices matrix provides basic shaping extracting
dp	real fortran literal precision double
prime	'prime' represents prime number handler key test expression
gray	gray essentially code n-dimensional edge hamiltonian walk length cube one
traverser	count multiset partitions methods enumerate
differential	set :math operator weyl exterior polynomial ring information container field intermediate derivative d/dx elements return form algebra operators polynomials noncommutative dx relating ore representing coefficients e extension differential base
coord	represents space contains system logic coordinate 3-d transformation
patch	manifold object representing patch
hankel2	function hankel second kind
acot	cotangent function inverse
wigner6j	symbols class wigner-6j
hankel1	function hankel kind first
common	common handlers useful methods defines
udivisor	function unitary calculate positive k sum([x**k equal n udivisor_sigma udivisors \sigma_k^* x integer ]) divisor
x	operator x sigma parameters pauli
fixed	fixed set number particle basis
set	mathematical available singleton set stores rewrite image expr-s numbers satisfies given cartesian things also sympy finite transformation empty function product elements parent dummy pairs base class condition represents kind geometryentity (compatible expr discrete sets examples
wrt	polynomial wrt functions option manipulation
gegenbauer	gegenbauer :math n nth c_n^{\left(\alpha\right)} alpha polynomial x gives
seq	operations represents based sequence periodic term-wise addition base sequences multiplication formula expression class
frame	mechanics frame classical reference
module	domain code homomorphism submodules monomial abstract module stored polynomial ring index submodule implementation rings homomoprhisms class ideal generalized wrappers product tuple zeroth free base thereof data relying term homomorphisms instantiate modules element concrete order quotient
num	functions printer piecewise vectorized operators logical etc handles numpy
sec	function secant
result	information return "outgoing" value base routine expression class
arg	real predicate args number exactly argument one returns complex holding representing class radians
zbra	quantum two-level bra system
dyadic	sums tensor basedyadics scalars super object component denote zero base products hold dyadic class dyadic-classes
contour	representation contour plot
tensor	upper stores symmetry exponentiated metric manage head single spaces tuple's unit hilbert index rely tensor parameters space separate two class forms future types sympy abstract arguments deprecation product warnings may lower base properties change represents tensorindextype e name versions [1]_ without experimental monoterm indices characterized
definite	handler key 'positive_definite'
partition	count represents methods integer abstract partition enumerate multiset class partitions
fcode	convert printer generator fortran code sympy expressions 95 strings
state	mechanics sequence abstract many-particle general states see numbers quantum occupied angular bra occupation binary qubitbra coupled particles also state describes bosonbra momentum used qubits orbits collection base representations ket class ======== particle many work fock fockstatefermion(ket/bra) time-dependent representation qubit fockstateboson(ket/bra)
gmpyfinite	field finite based gmpy integers
routine	set description generic routine expressions evaluation
tens	product tensor parameters abstract class tensors base sum expressions notes
mul	represents product matrix parameters basedyadics scalars basevectors basis base- term-wise class dependent scalar products denotes sequences multiplication expressions denote tensors quantity
geometric	matrix transfer representation geometric formalism ray
lazy	deprecation rely warnings may versions without experimental sympy future class change
jx	operator eigenket jx eigenbra coupled
jy	operator eigenket coupled jy eigenbra
jz	represents coupling jz coupled eigenket state eigenbra operator spin
complement	represents set complement relative another difference
javascript	convert printer "a python javascript code expressions strings
transpose	map matrix transposition transpose expression linear
covar	vector covariant base respect operator derivative
jn	spherical function kind bessel first
key	print printer equal objects
group	weyl relators number list/tuple api fpgroup directly specified elements lie group would create freegroup generators take way input finite defining semisimple used free tokens infinite representing class parentheses list equal permutation expression subgroup
ket	mechanics sequence many-particle general numbers quantum occupied occupation cartesian bosonic coupled state time-dependent 1d momentum jx jy jz orbits eigenket coherent base ket spin class fermionic represents coupling particle many time-independent fock mode representation kets
c	index lower b decrement increment
fresnels	fresnel integral
cot	cotangent function
limits	oriented represents additions unevaluated
qft	forward quantum fourier transform
region	represents set represent complex numbers
space	mechanics exponentiated abstract direct denote dimensional second spaces quantum ray tensor space transfer sum hilbert complex finite product free space-orienter class matrix vectors [1]_ quantization
s	gate version allows simplifications cgate
eta	function dirichlet eta
context	assumptions set representing
logic	expression logical
variance	expression symbolic variance
qubit	computational single unitary numbers bra binary qubitbra basis two gate multi-qubit store qubits base representations ket class integers work values qubit z
holonomic	function homogeneous satisfying linear sequence equation differential solution recurrence relation polynomial ordinary holonomic type coefficients
expression	raised commutative didn't arbitrary expressions property expression class
ci	cosine integral
sinh	function hyperbolic \frac{e^x - sine e^{-x}}{2}
point	point represents object manifold n-dimensional space dynamic system euclidean 3-d
simple	qq e g simple base zz domains class
pow	oo raised power expression y" -i singleton -oo 1 0 involving -1 definitions x**y : "x defines
cg	coefficient coupling describe angular momentum clebsch-gordan class coefficients
harmonic	given number harmonic \operatorname{h}_{n} nth numbers =
poly	module polynomial ring expressions special functions submodule generic distributed low-level pure solvable generalized multivariate free base operating polynomials representations representing class quintics element
anti	upper lower stores anticommutator antihermitian separate standard q state handler tuple's indices unevaluated
polynomial	multivariate dmf objects orthogonal polynomials representing rings related dmp exceptions base generalized polynomial ring true class
table	derivatives functions terms n-1 data create n properties representation ========== table bessel orders nice
slots	allows __slots__ objects mixin pickle class
asin1	)/sqrt represent 1/2], z) == asin(sqrt hyper([1/2 [3/2], z
iterable	use return creating called iterable() instances supposed mixin true class
mathieu	mathieu abstract base class functions
sieve	prime sieve dynamically list growing numbers infinite implemented eratosthenes
commutative	raised 'commutative' commutative didn't handler key property expression
c89code	c printer python convert code expressions strings
basis	set number denote states instances scalar bosonic containing zero basis sum expressed denotes instance state fock functionality mul dyadics product dependent quantities groebner cannot variable super class single represents particle vectors base- base common fixed reduced quantity
union	union represents set :class sets
create	operator creation bosonic fermionic
py	relevant features logical used stdlib extract functions statistics piecewise vectorized py doctests handles contained test sympy numpy identical outputchecker printer run reporter operators object docstring given compared accumulate cases class like deprecated etc produce doctest docstrings output warning
detected	tautology reporting detected prover internal uses
sinc	function represents sinc unnormalized examples
literal	real double literal precision fortran single
cosine	inverse unevaluated cosine transforms base sine representing class
basic	sympy base class objects
tensorflow	functions printer piecewise vectorized operators logical max/min handles relational tensorflow
pi	legendre kind n, third \pi defined m, integral three arguments elliptic evaluates constant z called incomplete
empty	available represents singleton set sequence empty
determinant	operations represents determinant matrix provides basic expression
ccode	deprecated c code generator
acoth	cotangent function inverse hyperbolic
covariance	expression symbolic covariance
traversal	tree pre-order traversal
coherent	state coherent mode ket bosonic bra
lift	logarithm riemann argument surface standard lift branch using
dsign	double precision sign fortran arguments intrinsic
spin	coupled operators angular states base spin class momentum
applied	function predicate applying undefined tokens application base resulting arguments group expressions representing class
exception	function exception used another algorithm within one indicate subroutines risch elementary integrated
reciprocal	functions reciprocal hyperbolic trigonometric base class
lagranges	object method lagrange's
single	domain set probability symbol/set random represented single superclass normal/exponential/uniformdistribution univariate space probabilities variable/symbol support etc also singlecontinuousdistribution finite roll *single* symbol continuous attributed variable using poissondistribution represents finitedomain consist die interval see serves events possibilities discrete distribution example
value	exception internal raised use _get_coeff_exp
n	number
deferred	whose use e g lambdify deferred vector components
finder	given relevant object docstring doctests contained used docstrings extract class
error	raised computing mainly module shape relation transforms polynomial use matrix class internal reorder core missing dependent assignment problems wrong base related variable trying _get_coeff_exp exception limits geometry classes exceptions _rewrite_gamma loop
wild	function explicitly anything matches symbol whatever wildfunction without arguments excluded wild
shostate	states state class sho
unitary	unitary == 1 handler u 'unitary' key operator u*dagger satisfies
coupled	eigenket jx jy jz coupled class states state base eigenbra represents spin angular momentum coupling
surface	surfaces parametric three surface consisting 2d range base sympy representation expressions expression class 3d
cant	sympification instances trait disallow mix class
cond	represents matches conditionally pair token wild expression condition
in	don't certain never >>> base routine sympy initialized attributes inoutargument class 'inherit'
fermion	dagger sequence creation many-particle see operator satisfies occupied bra 1 also state == orbits {c base ket class fermionic ======== c annihilation fock fockstatefermion(ket/bra) mode }
wigner9j	symbols wigner-9j class
generic	polynomial representations base class low-level
sqrt	function represents square root
lambert	function inverse lambert [1]_ defined \exp w z
complex	represent domain set dimensional numbers polynomial given space complex handler indexed finite infinity precision qualified vectors hilbert represents isolation interval element q fully representation root
split	polynomial functions manipulation split option
pauli	matrix needed representing symbol number properties algebraic pauli multiplication matrices class left
bernoulli	sequence bernoulli polynomials numbers rational /
finite	domain set finitedomains finiteset symbol/set random number general single spaces examples events based probability density probabilities restricted support field handler finite roll independent *single* integers 'finite' collection key represented using python's class condition represents several finitedomain die space consisting possibilities discrete fields example numbers
extended	q handler extended_real
infinity	infinity positive negative complex infinite quantity
keys	supported keys contains ask class
assignment	represents raised code missing generation assignment assignments base variable class loop augmented
segment3d	line undirected segment space 3d
sym	relevant associated features reference frame scalar warning stdlib extract given statistics doctests contained test sympy outputchecker used run object docstring symbol/base compared accumulate cases class deprecated wrt doctest docstrings coordinate
sys	coordinate represents 3-d system space
two	unitary two base gate qubit class
expint	integral generalized exponential
identity	reduce scalar operator satisfies matrix * - wrapper >>> gate function == sympy class identity represents circuits single value multiplicative qubit morphism op
cycle	around wrapper functionality provides disjoint dict cycle
lower	handler key 'lower_triangular'
hbar	constant form [1]_ numerical symbolic plank's reduced
undefined	functions meta class undefined
polys	polys polynomial flag functions manipulation
floor	function greater floor argument value returns largest integer univariate
lambdify	function return vectorized sufficiently returns lambdified smart
solve	met raised conditions weren't solver's
factorial	function integers functions valued also implementation double symbol hypergeometric related nonnegative factorial pochhammer concrete rising mathematics falling arising called
y	operator sigma parameters pauli
position	cartesian class eigenket base eigenbra position eigenstates 3d
parametric	three surface range sympy representation expressions parametric consisting 3d
dimension	represent set dimensions represents dimensionsystem quantities dimension coherent class physical
spherical	spherical functions base bessel class
manifold	mathematical manifold object representing
graded	monomials order reversed graded lexicographic
less	use intended general
monomial	functions code e generator monomial powers product fast base orderings representing class arithmetic
fibonacci	sequence numbers polynomials defined fibonacci integer /
compound	node represent little analagous tree interior sympy class
shape	shape wrong matrix
atomic	exprs object class parent atoms
over2drange	surface 2d range sympy representation expression consisting 3d
laguerre	laguerre :math nth returns generalized polynomial x l_n
prufer	correspondence code algorithm bijection trees labeled describes prufer
singularity	discontinuous take singularity functions class
prefix	represent name symbol prefixes factor class
generator	things actually creating constructor
density	domain density states mixed operator finite representing
bell	satisfy bell polynomials 1 numbers b_0 = /
lattice	operations algebraic join/meet lattice[1]
add	denote instances sequences expressions unevaluated dyadic additions matrix parameters basis addition sum expressed denotes oriented mul dependent quantities sums term-wise tensors cannot base hold class represents vector
cmplx	function fortran conversion complex
hermite	(-\infty h_n orthogonal hermite polynomials n nth \infty) :math polynomial x gives
mod	represents operation modulo expressions symbolic
euler	given constant euler-mascheroni numbers : euler
real	real domain extended_real handler interval given isolation q qualified numbers precision fully representation element
xnor	function xnor logical
ops	functions code generator monomial fast arithmetic
rules	space rules describe implications quickly defined deduce determined allow logic facts
evaluate	changed global_evaluate whenever cache cleared must
qexpr	like operators object states base quantum class
erf2inv	function erf2inv inverse defined two-argument error
catalan	given constant number n-th catalan catalan's : numbers
grid	growable holds constructs diagram fitting objects grid
integer	represents partition based int type representing rings general q modular handler integer ring python's class
intersection	represents set intersection :class sets
formal	function represents functions power series flag manipulation polynomial formal
d	function index lower elements wigner matrix wigner-d increment decrement d-function rotation gives
particle	particle
primeomega	prime calculate factors positive number n multiplicities integer counting
zgate	gate single z qubit
subfactorial	integers non-negative defined items derangements n : counts subfactorial
mpmath	printer maintains precision mpmath lambda floats
hypot	function represents hypotenuse
sparse	elements matrix create number large zero version sparse immutable
ray3d	semi-line direction space point source ray
reduced	function reduced_totient calculate 0 \lambda n > smallest totient carmichael reduced lambda
picklable	allows __slots__ objects mixin pickle class
mathieucprime	function mathieu c^{\prime} q cosine derivative z
sequence	homogeneous represents satisfying linear sequence recurrence relation empty polynomial holonomic type coefficients
fresnel	fresnel base class integrals
conditional	domain finitedomain restricted support continuous attached roll possibilities also see randomdomain die example condition
bra3d	position cartesian eigenbra 3d
airybi	function airy second \operatorname{bi} kind
asin2	)/sqrt represent 1-z 1], hyper([1 == asin(sqrt /sqrt [3/2], z z)
printer	vectorialexpressions code interpretation "a figure subclasses ir computations julia max/min see infrastructure converts numbers expressions mpmath ascii-art llvm functions maintains piecewise generic vectorized etc intervals fortran handles internal theano sympy use printers print new numpy vector printer string latex python operators javascript c precision objects implementing job base repr sstrrepr tensorflow mpi class floats easily convert octave/matlab -- deprecated equal lambdify 2d provide logical r used code-printing relational pretty expression strings rust lambda
diff	derivatives expressions store
line2d	infinite 2d line space
shoket	eigenket 1d
slice	expression matrixslice matrix
dense	create version immutable matrix
for	'for-loop' represents code
per	represents periodic sequence
prop	kb propositional indexing inefficient logic
bra	mechanics computational coupled general see numbers quantum bosonic bra binary cartesian basis particles also state describes 1d bosonbra momentum multi-qubit store bras jx jy jz collection coherent base class fermionic ======== integers time-independent fock values mode time-dependent representation qubit z eigenbra
xket	eigenket position cartesian 1d
bessel	bessel-type derivatives functions terms n-1 abstract n class base spherical bessel orders
minimal	object method implementing minimum functionality every providing class matrix-like
besseli	function kind bessel modified first
core	exceptions core base class related
besselk	function second bessel modified kind
besselj	function kind bessel first
power	function represents power exponentiated series space [1]_ hilbert formal
equivalent	equivalence relation
bessely	function second bessel kind
quaternion	quaternion-orienter class denote
binomial	implementation coefficient defined binomial
mellin	exception inverse use mainly raised _rewrite_gamma internal transforms unevaluated representing class mellin
output	outputchecker compared always outputargument stdlib routine initialized class
hadamard	product stores matrix object symbolic argument without single elementwise simply hadamard gate expressions qubit
tautological	wrapper value boolean allowing truth query expression
properties	matrix old-style assumptions provides basic classes metaclass properties
cnot	controlled-not qubit two
refraction	matrix transfer refraction interface curved ray
integers	represents set integers positive negative also zero
extension	information functions container option extension differential manipulation polynomial relating
of	represents matrix m, equivalent diagonalof diagonal polynomial indexed represented root complex expression create univariate
piecewise	function represents piecewise
range	represents range stop called integers
plus	operator plus sigma parameters pauli
naturals0	represents non-negative inclusive zero numbers integers whole
cos	function cosine
acos	function cosine inverse
or	function giving logical arguments immediately evaluates true order
gamma	function constant gamma euler-mascheroni
op	operations dagger often j+ number j- simply sequences operator lattice[1] satisfies bosonic jz write cartesian commutative covariant spin ] 1 [a parts 1d pauli derivative momentum lowering jx jy useful separate == operators a^dagger*a {c algebraic noncommutative base 'a' respect class raising fermionic c join/meet sigma a^dagger vector } associative
dagger	operators creation/annihilation hermitian conjugate operation general
subs	represents pairs expr-s stores dummy expr rewrite substitutions unevaluated expression
image	mathematical function image set transformation
float	represent arbitrary number precision floating-point
integral	raised computing variables within integral trigonometric one relation transforms another elementary unevaluated integration indicate subroutines test integrated nonelementary function used integrals problems indexed base class fresnel represents exception algorithm risch experimental
stieltjes	function represents stieltjes laurent riemann :math expansion series zeta \gamma_{k} occur constants
three	body orienters super-class space
asec	function inverse secant
hermitian	dagger antihermitian == h q hermitian handler operator satisfies
jplus	operator j+
rising	function functions valued concrete factorial double symbol hypergeometric also pochhammer rising mathematics arising called
strip	exception use mainly raised internal _rewrite_gamma
elementary	function represents exception used another algorithm within integral one indicate subroutines risch elementary integrated nonelementary
bosonic	set particle basis state number states single fock base variable fixed bosonic class
ellipse	geometryentity elliptical
log	logarithm function natural \ln \log x
transfer	transfer base matrix class ray
transform	raised computing integral relation transforms unevaluated use inverse generic internal immutable used mainly problems mapping hankel base mellin sine representing class exception laplace cosine rule transformation fourier _rewrite_gamma
custom	represent workaround get certain rcall better facts way interface lambda
strict	polynomial strict functions option manipulation
growable	holds grid growable objects
inner	product ket bra inner unevaluated [1]
fraction	function multivariate fields rational representing class
var	set particle basis state number single variable
log10	logarithm represents function base ten
wigner3j	wigner coupling symbols 3j-symbols determined wigner-3j class coefficients
function	homogeneous mathematical wildfunction g-function hypergeometric functionclass meta boolean polynomial take functions inverse group matrix space rounding meijer subclass combinatorial arguments ordinary type generalized function used linear matches trigonometric tokens base lives using singularity representing class coefficients applied represents hyperbolic undefined reciprocal equation differential solution etc classes identity holonomic discontinuous lambda
head	head tensor parameters
medium	prime represents medium reason optical implement class
form	optimizing knows extension applications signs double create basic minus stringpict representation table data class math nice
kb	indexing specialised kind inference knowledge kb rules compiled factkb built-in use class simple objects bases base basic propositional relying inefficient logic
kronecker	function discrete delta kronecker
triangular	'upper_triangular' handler key 'lower_triangular'
atom	parent things subexpressions base atomic atom booleanfalse booleantrue expression class
e	kind defined m, integral two second arguments elliptic evaluates z called incomplete
line	space range sympy infinite representation line expression consisting
with	represents allows oriented __slots__ objects mixin additions unevaluated pickle class
raising	operator a^dagger raising
morphism	category represents name abstract composition base morphisms class identity morphism
state3d	cartesian class base position eigenstates 3d
coset	========== properties
annihilate	annihilation operator bosonic fermionic
dmf	fractions multivariate k dense
default	default implementation printing classes sympy
characteristic	infinite domain elements number
coeff	exception internal raised use _get_coeff_exp
bounds	represent # accumulationbounds accumbounds interval note alias [a closed always b],
dmp	multivariate k dense polynomials
un	upper lower b index increment decrement
limit	represents unevaluated limit
erfcinv	function inverse complementary defined error erfcinv
over1drange	range sympy representation line expression consisting
distribution	normal/exponential/uniformdistribution etc continuous serves discrete single superclass variable distribution poissondistribution
z	operator z sigma parameters pauli
log1p	logarithm represents natural number one plus
laplace	inverse laplace transforms unevaluated representing class
rust	convert printer generator python code expressions strings rust
line2dbase	2d base lines class
interval	real represents containing set end fully interval use mpi intervals start qualified points numbers isolation print representation floating complex printer lambda
constant	rationals behaviors p abstract derived specific define base q probably attributes classes class must
item	values subsequence return class helper
int	binary integers qubits work bra base values numbers representations qubit ket class store
cmod	gate controlled mod
universal	represents set things
mirror	reflection transfer surface curved ray matrix
asinh	function inverse sine hyperbolic
dirac	function derivatives diracdelta
prover	given set prove ai initial - tries possible rules prover logic
warning	deprecated warning features sympy
evalf	adding capabililty class mixin evalf
polygon	regular two-dimensional polygon
no	represent used brackets don't ordering certain object >>> base normal sympy attributes class 'inherit'
na	number
wavefunction	takes continuous coordinates bases constructor representations expression class
hn1	spherical hankel function kind first
field	real domain manifold mpq number general scalar numbers polynomial given based representing distributed system field complex rational finite type function multivariate option integers python functions precision algebraic base gmpy manipulation python's class represents fields vector coordinate
hn2	spherical hankel function second kind
branch	logarithm represent riemann polar number surface branch quotient reduced principal
test	relevant extract given statistics py doctests contained test identical used run reporter object docstring produce accumulate cases class like doctest docstrings output
zeta	hurwitz function zeta riemann
arithmetic	operations arithmetic matrix provides basic
yop	cartesian 2d operator systems coordinate 3d
polar	logarithm represent sphinx riemann number' g-function documentation argument surface standard see lift branch using 'polar
latex	vector latex expressions printer
polylog	function polylogarithm
symbol	probabilityspaces object matrix represent symbol random symbolic value symbols assumptions principle representation sympy expressions creates take
lens	lens transfer thin matrix ray
commutator	unevaluated ordered anticommutator b*a state fields - two according commutator [a vector arguments b] a*b standard =
registry	registers singleton registry[c] objects handlers handler avoid register namespace imports needed s) classes cyclic registry base sympy (accessible problems = class
variable	represents matches typed conditionally wild token variable
gmpyinteger	based type gmpy's integer ring mpz
structure	dummy contains free handles ones indices class
erf2	function defined two-argument error
implies	implication logical
required	matrix required objects listed implement subclasses properties must
curve	curve space
delta	function derivatives diracdelta kronecker discrete delta
fact	inference defined describe built-in deduce registers facts handler use knowledge space factkb quickly simple classes basic = registry[c] rules compiled class objects base propositional relying specialised kind handlers register implications determined allow logic
time	mechanics general state base time-dependent quantum ket class bra
oracle	box gate black
rigid	idealized body rigid
application	applied functions base class
acsc	function inverse cosecant
augmented	assignments base class augmented
